Codebeschijving	Engels	Nederlands
aaa, Name for	Ghotuo	Ghotuo
aab, Name for	Alumu-Tesu	Alumu-Tesu
aac, Name for	Ari	Ari
aad, Name for	Amal	Amal
aae, Inverted name for	Albanian, Arbëreshë	Albanees, Arbëreshë
aae, Name for	Arbëreshë Albanian	Arbëreshë Albanees
aaf, Name for	Aranadan	Aranadan
aag, Name for	Ambrak	Ambrak
aah, Inverted name for	Arapesh, Abu'	Arapesh, Abu'
aah, Name for	Abu' Arapesh	Abu' Arapesh
aai, Name for	Arifama-Miniafia	Arifama-Miniafia
aak, Name for	Ankave	Ankave
aal, Name for	Afade	Afade
aan, Name for	Anambé	Anambé
aao, Inverted name for	Arabic, Algerian Saharan	Arabisch, Algerijns Sahara
aao, Name for	Algerian Saharan Arabic	Algerijns Sahara Arabisch
aap, Inverted name for	Arára, Pará	Arára, Pará
aap, Name for	Pará Arára	Pará Arára
aaq, Inverted name for	Abnaki, Eastern	Abnaki, Oostelijk
aaq, Name for	Eastern Abnaki	Oostelijk Abnaki
aar, Name for	Afar	Afar
aas, Name for	Aasáx	Aasáx
aat, Inverted name for	Albanian, Arvanitika	Albanees, Arvanitika
aat, Name for	Arvanitika Albanian	Arvanitika Albanees
aau, Name for	Abau	Abau
aaw, Name for	Solong	Solong
aax, Name for	Mandobo Atas	Mandobo Atas
aaz, Name for	Amarasi	Amarasi
aba, Name for	Abé	Abé
abb, Name for	Bankon	Bankon
abc, Inverted name for	Ayta, Ambala	Ayta, Ambala
abc, Name for	Ambala Ayta	Ambala Ayta
abd, Name for	Manide	Manide
abe, Inverted name for	Abnaki, Western	Abnaki, Westelijk
abe, Name for	Western Abnaki	Westelijk Abnaki
abf, Name for	Abai Sungai	Abai Sungai
abg, Name for	Abaga	Abaga
abh, Inverted name for	Arabic, Tajiki	Arabisch, Tadzjieks
abh, Name for	Tajiki Arabic	Tadzjieks Arabisch
abi, Name for	Abidji	Abidji
abj, Name for	Aka-Bea	Aka-Bea
abk, Name for	Abkhazian	Abchazisch
abl, Name for	Lampung Nyo	Lampung Nyo
abm, Name for	Abanyom	Abanyom
abn, Name for	Abua	Abua
abo, Name for	Abon	Abon
abp, Inverted name for	Ayta, Abellen	Ayta, Abellen
abp, Name for	Abellen Ayta	Abellen Ayta
abq, Name for	Abaza	Abaza
abr, Name for	Abron	Abron
abs, Inverted name for	Malay, Ambonese	Maleis, Ambonees
abs, Name for	Ambonese Malay	Ambonees Maleis
abt, Name for	Ambulas	Ambulas
abu, Name for	Abure	Abure
abv, Inverted name for	Arabic, Baharna	Arabisch, Bahrain
abv, Name for	Baharna Arabic	Bahrein Arabisch
abw, Name for	Pal	Pal
abx, Name for	Inabaknon	Inabaknon
aby, Name for	Aneme Wake	Aneme Wake
abz, Name for	Abui	Abui
aca, Name for	Achagua	Achagua
acb, Name for	Áncá	Áncá
acd, Name for	Gikyode	Gikyode
ace, Name for	Achinese	Achinees
acf, Inverted name for	Creole French, Saint Lucian	Frans, Saint Luciaans Creools
acf, Name for	Saint Lucian Creole French	Saint Luciaans Creools Frans
ach, Name for	Acoli	Acholi
aci, Name for	Aka-Cari	Aka-Cari
ack, Name for	Aka-Kora	Aka-Kora
acl, Name for	Akar-Bale	Akar-Bale
acm, Inverted name for	Arabic, Mesopotamian	Arabisch, Mesopotamisch
acm, Name for	Mesopotamian Arabic	Mesopotamisch Arabisch
acn, Name for	Achang	Achang
acp, Inverted name for	Acipa, Eastern	Acipa, Oostelijk
acp, Name for	Eastern Acipa	Oostelijk Acipa
acq, Inverted name for	Arabic, Ta'izzi-Adeni	Arabisch, Taiz-Aden
acq, Name for	Ta'izzi-Adeni Arabic	Taiz-Aden Arabisch
acr, Name for	Achi	Achi
acs, Name for	Acroá	Acroá
act, Name for	Achterhoeks	Achterhoeks
acu, Name for	Achuar-Shiwiar	Achuar-Shiwiar
acv, Name for	Achumawi	Achumawi
acw, Inverted name for	Arabic, Hijazi	Arabisch, Hijazisch
acw, Name for	Hijazi Arabic	Hijazisch Arabisch
acx, Inverted name for	Arabic, Omani	Arabisch, Omaans
acx, Name for	Omani Arabic	Omaans Arabisch
acy, Inverted name for	Arabic, Cypriot	Arabisch, Cypriotisch
acy, Name for	Cypriot Arabic	Cypriotisch Arabisch
acz, Name for	Acheron	Acheron
ada, Name for	Adangme	Adangme
adb, Name for	Adabe	Adabe
add, Name for	Dzodinka	Dzodinka
ade, Name for	Adele	Adele
adf, Inverted name for	Arabic, Dhofari	Arabisch, Dhofari
adf, Name for	Dhofari Arabic	Dhofarisch Arabisch
adg, Name for	Andegerebinha	Andegerebinha
adh, Name for	Adhola	Adhola
adi, Name for	Adi	Adi
adj, Name for	Adioukrou	Adioukrou
adl, Name for	Galo	Galo
adn, Name for	Adang	Adang
ado, Name for	Abu	Abu
adq, Name for	Adangbe	Adangbe
adr, Name for	Adonara	Adonara
adt, Name for	Adnyamathanha	Adnyamathanha
adu, Name for	Aduge	Aduge
adw, Name for	Amundava	Amundava
adx, Inverted name for	Tibetan, Amdo	Tibetaans, Amdo
adx, Name for	Amdo Tibetan	Amdo Tibetaans
ady, Name for	Adyghe	Adygees; West-Circassisch
adz, Name for	Adzera	Adzera
aea, Name for	Areba	Areba
aeb, Inverted name for	Arabic, Tunisian	Arabisch, Tunesisch
aeb, Name for	Tunisian Arabic	Tunesisch Arabisch
aec, Inverted name for	Arabic, Saidi	Arabisch, Saidi
aec, Name for	Saidi Arabic	Saoedisch Arabisch
aed, Name for	Argentine Sign Language	Argentijnse Gebarentaal
aee, Inverted name for	Pashai, Northeast	Pashai, Noordoostelijk
aee, Name for	Northeast Pashai	Noordoostelijk Pashai
aek, Name for	Haeke	Haeke
ael, Name for	Ambele	Ambele
aem, Name for	Arem	Arem
aen, Name for	Armenian Sign Language	Armeense Gebarentaal
aeq, Name for	Aer	Aer
aer, Inverted name for	Arrernte, Eastern	Arrernte, Oostelijk
aer, Name for	Eastern Arrernte	Oostelijk Arrernte
aes, Name for	Alsea	Alsea
aeu, Name for	Akeu	Akeu
aew, Name for	Ambakich	Ambakich
aey, Name for	Amele	Amele
aez, Name for	Aeka	Aeka
afb, Inverted name for	Arabic, Gulf	Arabisch, Golf
afb, Name for	Gulf Arabic	Golf-Arabisch
afd, Name for	Andai	Andai
afe, Name for	Putukwam	Putukwam
afg, Name for	Afghan Sign Language	Afghaanse Gebarentaal
afh, Name for	Afrihili	Afrihili
afi, Name for	Akrukay	Akrukay
afk, Name for	Nanubae	Nanubae
afn, Name for	Defaka	Defaka
afo, Name for	Eloyi	Eloyi
afp, Name for	Tapei	Tapei
afr, Name for	Afrikaans	Afrikaans
aft, Name for	Afitti	Afitti
afu, Name for	Awutu	Awutu
afz, Name for	Obokuitai	Obokuitai
aga, Name for	Aguano	Aguano
agb, Name for	Legbo	Legbo
agc, Name for	Agatu	Agatu
agd, Name for	Agarabi	Agarabi
age, Name for	Angal	Angal
agf, Name for	Arguni	Arguni
agg, Name for	Angor	Angor
agh, Name for	Ngelima	Ngelima
agi, Name for	Agariya	Agariya
agj, Name for	Argobba	Argobba
agl, Name for	Fembe	Fembe
agm, Name for	Angaataha	Angaatiha
ago, Name for	Tainae	Tainae
agq, Name for	Aghem	Aghem
ags, Name for	Esimbi	Esimbi
agu, Name for	Aguacateco	Aguacateken
agw, Name for	Kahua	Kahua
agx, Name for	Aghul	Aghul
agy, Inverted name for	Alta, Southern	Alta, Zuidelijk
agy, Name for	Southern Alta	Zuid-Alta
agz, Inverted name for	Agta, Mt. Iriga	Agta, Mt. Iriga
agz, Name for	Mt. Iriga Agta	Mt. Iriga Agta
aha, Name for	Ahanta	Ahanta
ahb, Name for	Axamb	Axamb
ahh, Name for	Aghu	Aghu
ahk, Name for	Akha	Akha
ahl, Name for	Igo	Igo
ahr, Name for	Ahirani	Ahirani
aht, Name for	Ahtena	Ahtena
aia, Name for	Arosi	Arosi
aib, Name for	Ainu (China)	Aino (China)
aic, Name for	Ainbai	Ainbai
aid, Name for	Alngith	Alngith
aie, Name for	Amara	Amara
aif, Name for	Agi	Agi
aig, Name for	Antigua and Barbuda Creole English	Antigua en Barbuda Creools Engels
aij, Name for	Lishanid Noshan	Lishanid Noshan
aik, Name for	Ake	Ake
ail, Name for	Aimele	Aimele
aim, Name for	Aimol	Aimol
ain, Name for	Ainu (Japan)	Aino (Japan)
aio, Name for	Aiton	Aiton
aip, Name for	Burumakok	Burumakok
aiq, Name for	Aimaq	Aimaq
air, Name for	Airoran	Airoran
ais, Inverted name for	Amis, Nataoran	Amis, Nataoran
ais, Name for	Nataoran Amis	Nataoran Amis
aiw, Name for	Aari	Aari
aix, Name for	Aighon	Aigon
aiy, Name for	Ali	Ali
ajn, Name for	Andajin	Andajin
ajp, Inverted name for	Arabic, South Levantine	Arabisch, Zuid-Levantijns
ajp, Name for	South Levantine Arabic	Zuid-Levantijns Arabisch
ajt, Inverted name for	Arabic, Judeo-Tunisian	Arabisch, Judeo-Tunesisch
ajt, Name for	Judeo-Tunisian Arabic	Judeo-Tunesisch Arabisch
aju, Inverted name for	Arabic, Judeo-Moroccan	Arabisch, Judeo-Marokkaans
aju, Name for	Judeo-Moroccan Arabic	Judeo-Marokkaans Arabisch
ajw, Name for	Ajawa	Ajawa
ajz, Inverted name for	Karbi, Amri	Karbi, Amri
ajz, Name for	Amri Karbi	Amri Karbi
aka, Name for	Akan	Akaans
akb, Name for	Batak Angkola	Batak Angkola
ake, Name for	Akawaio	Akawaio
akf, Name for	Akpa	Akpa
akg, Name for	Anakalangu	Anakalangu
aki, Name for	Aiome	Aiome
akk, Name for	Akkadian	Akkadiaans
akl, Name for	Aklanon	Aklanon
akm, Name for	Aka-Bo	Aka-Bo
akq, Name for	Ak	Ak
akr, Name for	Araki	Araki
aku, Name for	Akum	Akum
akw, Name for	Akwa	Akwa
akz, Name for	Alabama	Alabama
ala, Name for	Alago	Alago
alc, Name for	Qawasqar	Qawasqar
ald, Name for	Alladian	Alladian
ale, Name for	Aleut	Aleut
alh, Name for	Alawa	Alawa
ali, Name for	Amaimon	Amaimon
alj, Name for	Alangan	Alangan
alk, Name for	Alak	Alak
all, Name for	Allar	Allar
alm, Name for	Amblong	Amblong
aln, Inverted name for	Albanian, Gheg	Albanees, Gegisch
aln, Name for	Gheg Albanian	Gheg-Albanees
alq, Name for	Algonquin	Algonkisch
als, Inverted name for	Albanian, Tosk	Albanees, Toskisch
als, Name for	Tosk Albanian	Tosk-Albanees
alt, Inverted name for	Altai, Southern	Altajs, Zuidelijk
alt, Name for	Southern Altai	Zuid-Altai
alx, Name for	Amol	Alatil
aly, Name for	Alyawarr	Alyawarr
amc, Name for	Amahuaca	Amahuaca
amf, Name for	Hamer-Banna	Hamer-Banna
amh, Name for	Amharic	Amhaars
amj, Name for	Amdang	Amdang
amk, Name for	Ambai	Ambai
aml, Name for	War-Jaintia	War-Jaintia
amn, Name for	Amanab	Amanab
amp, Name for	Alamblak	Alamblak
amq, Name for	Amahai	Amahai
amr, Name for	Amarakaeri	Amarakaeri
ams, Inverted name for	Amami-Oshima, Southern	Amami-Oshima, Zuidelijk
ams, Name for	Southern Amami-Oshima	Zuid-Amami-Oshima
amy, Name for	Ami	Ami
amz, Name for	Atampaya	Atampaya
anb, Name for	Andoa	Andoa
anc, Name for	Ngas	Ngas
ang, Inverted name for	English, Old (ca. 450-1100)	Engels, Old (ca. 450-1100)
ang, Name for	Old English (ca. 450-1100)	Oudengels (ca.450-1100)
anh, Name for	Nend	Nend
ani, Name for	Andi	Andi
ank, Name for	Goemai	Goemai
anl, Inverted name for	Chin, Anu-Hkongso	Chin, Anu-Hkongso
ann, Name for	Obolo	Obolo
anp, Name for	Angika	Angika
anq, Name for	Jarawa (India)	Jarawa (India)
anr, Name for	Andh	Andh
ans, Name for	Anserma	Anserma
anv, Name for	Denya	Denya
anw, Name for	Anaang	Anaang
any, Name for	Anyin	Anyin
aoa, Name for	Angolar	Angolar
aoc, Name for	Pemon	Pemon
aod, Name for	Andarum	Andarum
aof, Name for	Bragat	Bragat
aoh, Name for	Arma	Arma
aoj, Name for	Mufian	Mufian
aor, Name for	Aore	Aore
aos, Name for	Taikat	Taikat
aot, Name for	Atong (India)	Atong (India)
aox, Name for	Atorada	Atorada
apb, Name for	Sa'a	Sa'a
apc, Inverted name for	Arabic, North Levantine	Arabisch, Noord-Levantijns
apc, Name for	North Levantine Arabic	Noord-Levantijns Arabisch
apd, Inverted name for	Arabic, Sudanese	Arabisch, Sudanees
apd, Name for	Sudanese Arabic	Sudanees Arabisch
apf, Name for	Pahanan Agta	Pahanan Agta
apg, Name for	Ampanang	Ampanang
aph, Name for	Athpariya	Athpariya
api, Name for	Apiaká	Apiaká
apo, Name for	Ambul	Ambul
app, Name for	Apma	Apma
apv, Name for	Alapmunte	Alapmunte
apx, Name for	Aputai	Aputai
aqc, Name for	Archi	Archi
aqg, Name for	Arigidi	Arigidi
aqn, Inverted name for	Alta, Northern	Altajs, Noordelijk
aqn, Name for	Northern Alta	Noordelijk-Altajs
aqt, Name for	Angaité	Angaité
aqz, Name for	Akuntsu	Akuntsu
ara, Name for	Arabic	Arabisch
arb, Inverted name for	Arabic, Standard	Arabisch, Standaard
arb, Name for	Standard Arabic	Standaard Arabisch
arc, Inverted name for	Aramaic, Official (700-300 BCE)	Aramees, Officieel (700-300 v.Chr.)
arc, Name for	Official Aramaic (700-300 BCE)	Officieel Aramees (700-300 v.Chr.)
ard, Name for	Arabana	Arabana
arg, Name for	Aragonese	Aragonees
arh, Name for	Arhuaco	Arhuaco
ari, Name for	Arikara	Arikara
arj, Name for	Arapaso	Arapaso
arl, Name for	Arabela	Arabela
arn, Name for	Mapudungun	Mapudungun
aro, Name for	Araona	Araona
arp, Name for	Arapaho	Arapaho
arq, Inverted name for	Arabic, Algerian	Arabisch, Algerijns
arq, Name for	Algerian Arabic	Algerijns Arabisch
ars, Inverted name for	Arabic, Najdi	Arabisch, Najdi
ars, Name for	Najdi Arabic	Najdi Arabisch
arw, Name for	Arawak	Arawak
ary, Inverted name for	Arabic, Moroccan	Arabisch, Marokkaans
ary, Name for	Moroccan Arabic	Marokkaans Arabisch
arz, Inverted name for	Arabic, Egyptian	Arabisch, Egyptisch
arz, Name for	Egyptian Arabic	Egyptisch Arabisch
asa, Name for	Asu (Tanzania)	Asu (Tanzania)
asd, Name for	Asas	Asas
ase, Name for	American Sign Language	Amerikaanse Gebarentaal
asf, Name for	Australian Sign Language	Australische Gebarentaal
asi, Name for	Buruwai	Buruwai
asj, Name for	Sari	Sari
ask, Name for	Ashkun	Ashkun
asm, Name for	Assamese	Assamees
aso, Name for	Dano	Dano
asp, Name for	Algerian Sign Language	Algerijnse Gebarentaal
asq, Name for	Austrian Sign Language	Oostenrijkse Gebarentaal
ass, Name for	Ipulo	Ipulo
ast, Name for	Asturian	Asturisch
asv, Name for	Asoa	Asoa
asw, Name for	Australian Aborigines Sign Language	Australische Aborigines Gebarentaal
atb, Name for	Zaiwa	Zaiwa
atm, Name for	Ata	Ata
atn, Name for	Ashtiani	Ashtiani
ato, Name for	Atong (Cameroon)	Atong (Kameroen)
atv, Inverted name for	Altai, Northern	Altajs, Noordelijk
atv, Name for	Northern Altai	Noordelijk Altajs
atx, Name for	Arutani	Arutani
aty, Name for	Aneityum	Aneityum
atz, Name for	Arta	Arta
aub, Name for	Alugu	Alugu
auc, Name for	Waorani	Waorani
aug, Name for	Aguna	Aguna
auh, Name for	Aushi	Aushi
auj, Name for	Awjilah	Awjilah
auk, Name for	Heyo	Heyo
aul, Name for	Aulua	Aulua
aup, Name for	Makayam	Makayam
auq, Name for	Anus	Anus
aur, Name for	Aruek	Aruek
auw, Name for	Awyi	Awyi
auy, Name for	Awiyaana	Awiyaana
auz, Inverted name for	Arabic, Uzbeki	Arabisch, Oezbeeks
auz, Name for	Uzbeki Arabic	Oezbeeks Arabisch
ava, Name for	Avaric	Avaars
avb, Name for	Avau	Avau
ave, Name for	Avestan	Avestaans
avi, Name for	Avikam	Avikam
avk, Name for	Kotava	Kotava
avn, Name for	Avatime	Avatime
avs, Name for	Aushiri	Aushiri
avu, Name for	Avokaya	Avokaya
awa, Name for	Awadhi	Awadhi
awh, Name for	Awbono	Awbono
awm, Name for	Arawum	Arawum
awo, Name for	Awak	Awak
awx, Name for	Awara	Awara
axe, Name for	Ayerrerenge	Ayerrerenge
axl, Inverted name for	Aranda, Lower Southern	Aranda, Neder Zuidelijk
axl, Name for	Lower Southern Aranda	Neder Zuidelijk Aranda
axm, Inverted name for	Armenian, Middle	Armeens, Midden
axm, Name for	Middle Armenian	Midden Armeens
aya, Name for	Awar	Awar
ayc, Inverted name for	Aymara, Southern	Aymara, Zuidelijk
ayc, Name for	Southern Aymara	Zuidelijk Aymara
aye, Name for	Ayere	Ayere
ayg, Name for	Ginyanga	Ginyanga
ayh, Inverted name for	Arabic, Hadrami	Arabisch, Hadramaut
ayh, Name for	Hadrami Arabic	Hadrami Arabisch
ayi, Name for	Leyigha	Leyigha
ayl, Inverted name for	Arabic, Libyan	Arabisch, Libisch
ayl, Name for	Libyan Arabic	Libisch Arabisch
aym, Name for	Aymara	Aymara
ayn, Inverted name for	Arabic, Sanaani	Arabisch, Sanaa
ayn, Name for	Sanaani Arabic	Sanaa Arabisch
ayo, Name for	Ayoreo	Ayoreo
ayp, Inverted name for	Arabic, North Mesopotamian	Arabisch, Noord-Mesopotamisch
ayp, Name for	North Mesopotamian Arabic	Noord-Mesopotamisch Arabisch
ayr, Inverted name for	Aymara, Central	Aymara, Centraal
ayr, Name for	Central Aymara	Centraal-Aymara
ays, Inverted name for	Ayta, Sorsogon	Ayta, Sorsogon
ays, Name for	Sorsogon Ayta	Sorsogon Ayta
ayu, Name for	Ayu	Ayu
ayz, Name for	Mai Brat	Mai Brat
aza, Name for	Azha	Azha
azb, Inverted name for	Azerbaijani, South	Azerbeidzjaans, Zuidelijk
azb, Name for	South Azerbaijani	Zuid-Azerbeidzjaans
azd, Inverted name for	Nahuatl, Eastern Durango	Nahuatl, Oostelijk Durango
azd, Name for	Eastern Durango Nahuatl	Oostelijk Durango Nahuatl
aze, Name for	Azerbaijani	Azerbeidzjaans
azj, Inverted name for	Azerbaijani, North	Azerbeidzjaans, Noordelijk
azj, Name for	North Azerbaijani	Noordelijk Azerbeidzjaans
azn, Inverted name for	Nahuatl, Western Durango	Nahuatl, Westelijk Durango
azn, Name for	Western Durango Nahuatl	Westelijk Durango Nahuatl
azo, Name for	Awing	Awing
baa, Name for	Babatana	Babatana
bac, Name for	Badui	Badui
bag, Name for	Tuki	Tuki
baj, Name for	Barakai	Barakai
bak, Name for	Bashkir	Basjkiers
bal, Name for	Baluchi	Beloetsji
bam, Name for	Bambara	Bambara
ban, Name for	Balinese	Balinees
bao, Name for	Waimaha	Waimaha
bap, Name for	Bantawa	Bantawa
bar, Name for	Bavarian	Beiers
bas, Name for	Basa (Cameroon)	Basa (Cameroen)
bau, Name for	Bada (Nigeria)	Bada (Nigerië)
bav, Name for	Vengo	Vengo
baw, Name for	Bambili-Bambui	Bambili-Bambui
bax, Name for	Bamun	Bamun
bay, Name for	Batuley	Batuley
bbb, Name for	Barai	Barai
bbd, Name for	Bau	Bau
bbe, Name for	Bangba	Bangba
bbf, Name for	Baibai	Baibai
bbg, Name for	Barama	Barama
bbh, Name for	Bugan	Bugan
bbi, Name for	Barombi	Barombi
bbl, Name for	Bats	Bats
bbm, Name for	Babango	Babango
bbq, Name for	Bamali	Bamali
bbr, Name for	Girawa	Girawa
bbs, Name for	Bakpinka	Bakpinka
bbv, Name for	Karnai	Karnai
bbw, Name for	Baba	Baba
bbx, Name for	Bubia	Bubia
bby, Name for	Befang	Befang
bcc, Inverted name for	Balochi, Southern	Balochi, Zuidelijk
bcc, Name for	Southern Balochi	Zuidelijk Balochi
bcd, Inverted name for	Babar, North	Babar, Noordelijk
bcd, Name for	North Babar	Noordelijk Babar
bce, Name for	Bamenyam	Bamenyam
bcf, Name for	Bamu	Bamu
bcg, Name for	Baga Pokur	Baga Pokur
bch, Name for	Bariai	Bariai
bcj, Name for	Bardi	Bardi
bck, Name for	Bunaba	Bunaba
bcl, Inverted name for	Bikol, Central	Bikol, Centraal
bcn, Name for	Bali (Nigeria)	Bali (Nigerië)
bco, Name for	Kaluli	Kaluli
bcq, Name for	Bench	Bench
bcr, Name for	Babine	Babine
bcs, Name for	Kohumono	Kohumono
bct, Name for	Bendi	Bendi
bcu, Name for	Awad Bing	Awad Bing
bcw, Name for	Bana	Bana
bcy, Name for	Bacama	Bacama
bda, Name for	Bayot	Bayot
bdb, Name for	Basap	Basap
bdd, Name for	Bunama	Bunama
bde, Name for	Bade	Bade
bdf, Name for	Biage	Biage
bdg, Name for	Bonggi	Bonggi
bdh, Name for	Baka (Sudan)	Baka (Soedan)
bdi, Name for	Burun	Burun
bdj, Name for	Bai	Bai
bdk, Name for	Budukh	Budukh
bdl, Inverted name for	Bajau, Indonesian	Bajau, Indonesisch
bdl, Name for	Indonesian Bajau	Indonesisch Bajau
bdm, Name for	Buduma	Buduma
bdn, Name for	Baldemu	Baldemu
bdo, Name for	Morom	Morom
bdp, Name for	Bende	Bende
bdq, Name for	Bahnar	Bahnar
bdr, Inverted name for	Bajau, West Coast	Bajau, Westkust
bdr, Name for	West Coast Bajau	Westkust Bajau
bds, Name for	Burunge	Burunge
bdt, Name for	Bokoto	Bokoto
bdu, Name for	Oroko	Oroko
bdv, Name for	Bodo Parja	Bodo Parja
bdw, Name for	Baham	Baham
bdx, Name for	Budong-Budong	Budong-Budong
bdy, Name for	Bandjalang	Bandjalang
bdz, Name for	Badeshi	Badeshi
bea, Name for	Beaver	Beaver
beb, Name for	Bebele	Bebele
bec, Name for	Iceve-Maci	Iceve-Maci
bed, Name for	Bedoanas	Bedoanas
bee, Name for	Byangsi	Byangsi
bef, Name for	Benabena	Benabena
beg, Name for	Belait	Belait
beh, Name for	Biali	Biali
bei, Name for	Bekati'	Bekati'
bej, Name for	Beja	Beja
bek, Name for	Bebeli	Bebeli
bel, Name for	Belarusian	Wit-Russisch; Belarussisch
bem, Name for	Bemba (Zambia)	Bemba (Zambia)
ben, Common name for	Bangla	Bangaals
ben, Name for	Bengali	Bengaals
beo, Name for	Beami	Beami
bep, Name for	Besoa	Besoa
beq, Name for	Beembe	Beembe
bes, Name for	Besme	Besme
beu, Name for	Blagar	Blagar
bew, Name for	Betawi	Betawi
bez, Name for	Bena (Tanzania)	Bena (Tanzania)
bfa, Name for	Bari	Bari
bfc, Inverted name for	Bai, Panyi	Bai, Panyi
bfc, Name for	Panyi Bai	Panyi Bai
bfd, Name for	Bafut	Bafut
bfe, Name for	Betaf	Betaf
bfg, Name for	Busang Kayan	Busang Kayan
bfi, Name for	British Sign Language	Britse Gebarentaal
bfm, Name for	Mmen	Mmen
bfn, Name for	Bunak	Bunak
bfp, Name for	Beba	Beba
bfq, Name for	Badaga	Badaga
bfr, Name for	Bazigar	Bazigar
bfs, Inverted name for	Bai, Southern	Bai, Zuidelijk
bfs, Name for	Southern Bai	Zuidelijk Bai
bft, Name for	Balti	Balti
bfu, Name for	Gahri	Gahri
bfw, Name for	Bondo	Bondo
bfx, Name for	Bantayanon	Bantayanon
bfy, Name for	Bagheli	Bagheli
bfz, Name for	Mahasu Pahari	Mahasu Pahari
bgb, Name for	Bobongko	Bobongko
bgc, Name for	Haryanvi	Haryanvi
bgd, Name for	Rathwi Bareli	Rathwi Bareli
bge, Name for	Bauria	Bauria
bgf, Name for	Bangandu	Bangandu
bgg, Name for	Bugun	Bugun
bgi, Name for	Giangan	Giangan
bgj, Name for	Bangolan	Bangolan
bgk, Name for	Bit	Bit
bgn, Inverted name for	Balochi, Western	West-Balochi
bgo, Name for	Baga Koga	Baga Koga
bgp, Inverted name for	Balochi, Eastern	Oost-Balochi
bgq, Name for	Bagri	Bagri
bgr, Inverted name for	Chin, Bawm	Chin, Bawm
bgr, Name for	Bawm Chin	Bawm Chin
bgs, Name for	Tagabawa	Tagabawa
bgt, Name for	Bughotu	Bughotu
bgu, Name for	Mbongno	Mbongno
bgv, Name for	Warkay-Bipim	Warkay-Bipim
bgw, Name for	Bhatri	Bhatri
bgx, Inverted name for	Turkish, Balkan Gagauz	Turks, Balkan Gagauz
bgx, Name for	Balkan Gagauz Turkish	Balkan Gagauz Turks
bgy, Name for	Benggoi	Benggoi
bgz, Name for	Banggai	Banggai
bha, Name for	Bharia	Bharia
bhb, Name for	Bhili	Bhili
bhc, Name for	Biga	Biga
bhd, Name for	Bhadrawahi	Bhadrawahi
bhe, Name for	Bhaya	Bhaya
bhf, Name for	Odiai	Odiai
bhg, Name for	Binandere	Binandere
bhh, Name for	Bukharic	Bukharic
bhi, Name for	Bhilali	Bhilali
bhj, Name for	Bahing	Bahing
bhl, Name for	Bimin	Bimin
bhm, Name for	Bathari	Bathari
bho, Name for	Bhojpuri	Bhojpuri
bhp, Name for	Bima	Bima
bhs, Name for	Buwal	Buwal
bht, Name for	Bhattiyali	Bhattiyali
bhu, Name for	Bhunjia	Bhunjia
bhv, Name for	Bahau	Bahau
bhw, Name for	Biak	Biak
bhx, Name for	Bhalay	Bhalay
bhy, Name for	Bhele	Bhele
bhz, Name for	Bada (Indonesia)	Bada (Indonesië)
bia, Name for	Badimaya	Badimaya
bib, Name for	Bissa	Bissa
bic, Name for	Bikaru	Bikaru
bid, Name for	Bidiyo	Bidiyo
bie, Name for	Bepour	Bepour
bif, Name for	Biafada	Biafada
big, Name for	Biangai	Biangai
bik, Name for	Bikol	Bikol
bil, Name for	Bile	Bile
bim, Name for	Bimoba	Bimoba
bin, Name for	Bini	Bini
bio, Name for	Nai	Nai
bip, Name for	Bila	Bila
biq, Name for	Bipi	Bipi
bir, Name for	Bisorio	Bisorio
bis, Name for	Bislama	Bislama
bit, Name for	Berinomo	Berinomo
biu, Name for	Biete	Biete
biv, Inverted name for	Birifor, Southern	Birifor, Zuid
biv, Name for	Southern Birifor	Zuidelijk Birifor
bix, Name for	Bijori	Bijori
biy, Name for	Birhor	Birhor
biz, Name for	Baloi	Baloi
bja, Name for	Budza	Budza
bjb, Name for	Banggarla	Banggarla
bjc, Name for	Bariji	Bariji
bje, Inverted name for	Mien, Biao-Jiao	Mien, Biao-Jiao
bje, Name for	Biao-Jiao Mien	Biao-Jiao Mien
bjh, Name for	Bahinemo	Bahinemo
bji, Name for	Burji	Burji
bjj, Name for	Kanauji	Kanauji
bjn, Name for	Banjar	Banjar
bjo, Name for	Mid-Southern Banda	Midden-Zuidelijk Banda
bjr, Name for	Binumarien	Binumarien
bjs, Name for	Bajan	Bajan
bju, Name for	Busuu	Busuu
bjv, Name for	Bedjond	Bedjond
bjy, Name for	Bayali	Bayali
bjz, Name for	Baruga	Baruga
bka, Name for	Kyak	Kyak
bkd, Name for	Binukid	Binukid
bkf, Name for	Beeke	Beeke
bkg, Name for	Buraka	Buraka
bki, Name for	Baki	Baki
bkj, Name for	Pande	Pande
bkl, Name for	Berik	Berik
bkn, Name for	Bukitan	Bukitan
bkq, Name for	Bakairí	Bakairí
bks, Inverted name for	Sorsoganon, Northern	Noord-Sorsoganon
bks, Name for	Northern Sorsoganon	Noordelijk Sorsoganon
bku, Name for	Buhid	Buhid
bkw, Name for	Bekwel	Bekwel
bla, Name for	Siksika	Siksika
blb, Name for	Bilua	Bilua
bld, Name for	Bolango	Bolango
blf, Name for	Buol	Buol
blg, Name for	Balau	Balau
blh, Name for	Kuwaa	Kuwaa
bli, Name for	Bolia	Bolia
blj, Name for	Bolongan	Bolongan
blk, Inverted name for	Karen, Pa'o	Karen, Pa'o
bll, Name for	Biloxi	Biloxi
bln, Inverted name for	Bikol, Southern Catanduanes	Bikol, Zuid-Catanduanes
blp, Name for	Blablanga	Blablanga
blr, Name for	Blang	Blang
bls, Name for	Balaesang	Balaesang
blv, Name for	Bolo	Bolo
blw, Name for	Balangao	Balangao
bly, Name for	Notre	Notre
blz, Name for	Balantak	Balantak
bma, Name for	Lame	Lame
bmb, Name for	Bembe	Bembe
bmc, Name for	Biem	Biem
bmd, Inverted name for	Manduri, Baga	Manduri, Baga
bmd, Name for	Baga Manduri	Baga Manduri
bmg, Name for	Bamwe	Bamwe
bmh, Name for	Kein	Kein
bmi, Name for	Bagirmi	Bagirmi
bmk, Name for	Ghayavi	Ghayavi
bml, Name for	Bomboli	Bomboli
bmo, Name for	Bambalang	Bambalang
bmp, Name for	Bulgebi	Bulgebi
bmr, Name for	Muinane	Muinane
bms, Inverted name for	Kanuri, Bilma	Kanuri, Bilma
bms, Name for	Bilma Kanuri	Bilma Kanuri
bmv, Name for	Bum	Bum
bmw, Name for	Bomwali	Bomwali
bmx, Name for	Baimak	Baimak
bmz, Name for	Baramu	Baramu
bnb, Name for	Bookan	Bookan
bnc, Name for	Bontok	Bontok
bnd, Name for	Banda (Indonesia)	Banda (Indonesië)
bne, Name for	Bintauna	Bintauna
bnf, Name for	Masiwang	Masiwang
bng, Name for	Benga	Benga
bni, Name for	Bangi	Bangi
bnl, Name for	Boon	Boon
bnm, Name for	Batanga	Batanga
bnp, Name for	Bola	Bola
bnq, Name for	Bantik	Bantik
bns, Name for	Bundeli	Bundeli
bnu, Name for	Bentong	Bentong
bnw, Name for	Bisis	Bisis
bnz, Name for	Beezen	Beezen
boa, Name for	Bora	Bora
bob, Name for	Aweer	Aweer
bod, Name for	Tibetan	Tibetaans
boe, Name for	Mundabli	Mundabli
bof, Name for	Bolon	Bolon
boh, Name for	Boma	Boma
bok, Name for	Bonjo	Bonjo
bol, Name for	Bole	Bole
bom, Name for	Berom	Berom
bon, Name for	Bine	Bine
bop, Name for	Bonkiman	Bonkiman
boq, Name for	Bogaya	Bogaya
bor, Name for	Borôro	Borôro
bos, Name for	Bosnian	Bosnisch
bot, Name for	Bongo	Bongo
bou, Name for	Bondei	Bondei
bov, Name for	Tuwuli	Tuwuli
bow, Name for	Rema	Rema
box, Name for	Buamu	Buamu
boy, Name for	Bodo (Central African Republic)	Bodo (Centraal-Afrikaanse Republiek)
boz, Inverted name for	Bozo, Tiéyaxo	Bozo, Tiéyaxo
bpa, Name for	Daakaka	Daakaka
bpb, Name for	Barbacoas	Barbacoas
bpd, Name for	Banda-Banda	Banda-Banda
bpg, Name for	Bonggo	Bonggo
bph, Name for	Botlikh	Botlikh
bpi, Name for	Bagupi	Bagupi
bpj, Name for	Binji	Binji
bpk, Name for	Orowe	Orowe
bpl, Name for	Broome Pearling Lugger Pidgin	Broome Pearling Lugger Pidgin
bpm, Name for	Biyom	Biyom
bpn, Name for	Dzao Min	Dzao Min
bpo, Name for	Anasi	Anasi
bpp, Name for	Kaure	Kaure
bpq, Inverted name for	Malay, Banda	Banda Malay
bpq, Name for	Banda Malay	Banda Malay
bpr, Inverted name for	Blaan, Koronadal	Koronadal Blaan
bps, Inverted name for	Blaan, Sarangani	Sarangani Blaan
bpt, Name for	Barrow Point	Barrow Point
bpu, Name for	Bongu	Bongu
bpv, Inverted name for	Marind, Bian	Bian Marind
bpv, Name for	Bian Marind	Bian Marind
bpw, Name for	Bo (Papua New Guinea)	Bo (Papua Nieuw Guinea)
bpx, Inverted name for	Bareli, Palya	Palya Bareli
bpy, Name for	Bishnupriya	Bishnupriya
bpz, Name for	Bilba	Bilba
bqa, Name for	Tchumbuli	Tchumbuli
bqb, Name for	Bagusa	Bagusa
bqc, Name for	Boko (Benin)	Boko (Benin)
bqd, Name for	Bung	Bung
bqf, Name for	Baga Kaloum	Baga Kaloum
bqg, Name for	Bago-Kusuntu	Bago-Kusuntu
bqh, Name for	Baima	Baima
bqi, Name for	Bakhtiari	Bakhtiari
bqj, Name for	Bandial	Bandial
bqk, Name for	Banda-Mbrès	Banda-Mbrès
bql, Name for	Bilakura	Bilakura
bqm, Name for	Wumboko	Wumboko
bqn, Name for	Bulgarian Sign Language	Bulgaarse Gebarentaal
bqo, Name for	Balo	Balo
bqp, Name for	Busa	Busa
bqq, Name for	Biritai	Biritai
bqr, Name for	Burusu	Burusu
bqs, Name for	Bosngun	Bosngun
bqt, Name for	Bamukumbit	Bamukumbit
bqu, Name for	Boguru	Boguru
bqv, Name for	Koro Wachi	Koro Wachi
bqw, Name for	Buru (Nigeria)	Buru (Nigeria)
bqx, Name for	Baangi	Baangi
bqz, Name for	Bakaka	Bakaka
bra, Name for	Braj	Braj
brb, Name for	Lave	Lave
brc, Inverted name for	Creole Dutch, Berbice	Creools Nederlands, Berbice
brc, Name for	Berbice Creole Dutch	Berbice Creools Nederlands
brd, Name for	Baraamu	Baraamu
bre, Name for	Breton	Bretons
brf, Name for	Bera	Bera
brg, Name for	Baure	Baure
brh, Name for	Brahui	Brahui
bri, Name for	Mokpwe	Mokpwe
brj, Name for	Bieria	Bieria
brk, Name for	Birked	Birked
brl, Name for	Birwa	Birwa
brm, Name for	Barambu	Barambu
brn, Name for	Boruca	Boruca
bro, Name for	Brokkat	Brokkat
brp, Name for	Barapasi	Barapasi
brq, Name for	Breri	Breri
brr, Name for	Birao	Birao
brs, Name for	Baras	Baras
brt, Name for	Bitare	Bitare
bru, Inverted name for	Bru, Eastern	Oostelijk Bru
bru, Name for	Eastern Bru	Oostelijk Bru
brv, Inverted name for	Bru, Western	Westelijk Bru
brv, Name for	Western Bru	Westelijk Bru
brw, Name for	Bellari	Bellari
brx, Name for	Bodo (India)	Bodo (India)
bry, Name for	Burui	Burui
brz, Name for	Bilbil	Bilbil
bsa, Name for	Abinomn	Abinomn
bsb, Inverted name for	Bisaya, Brunei	Brunei Bisaya
bsb, Name for	Brunei Bisaya	Brunei Bisaya
bsc, Name for	Bassari	Bassari
bse, Name for	Wushi	Wushi
bsf, Name for	Bauchi	Bauchi
bsg, Name for	Bashkardi	Bashkardi
bsh, Name for	Kati	Kati
bsi, Name for	Bassossi	Bassossi
bsj, Name for	Bangwinji	Bangwinji
bsk, Name for	Burushaski	Burushaski
bsl, Name for	Basa-Gumna	Basa-Gumna
bsm, Name for	Busami	Busami
bsn, Name for	Barasana-Eduria	Barasana-Eduria
bso, Name for	Buso	Buso
bsp, Name for	Baga Sitemu	Baga Sitemu
bsq, Name for	Bassa	Bassa
bsr, Name for	Bassa-Kontagora	Bassa-Kontagora
bss, Name for	Akoose	Akoose
bst, Name for	Basketo	Basketo
bsu, Name for	Bahonsuai	Bahonsuai
bsv, Name for	Baga Sobané	Baga Sobané
bsw, Name for	Baiso	Baiso
bsx, Name for	Yangkam	Yangkam
bsy, Inverted name for	Bisaya, Sabah	Sabah Bisaya
bta, Name for	Bata	Bata
btc, Name for	Bati (Cameroon)	Bati (Cameroen)
btd, Name for	Batak Dairi	Batak Dairi
bte, Name for	Gamo-Ningi	Gamo-Ningi
btf, Name for	Birgit	Birgit
btg, Inverted name for	Bété, Gagnoa	Gagnoa Bété
bth, Inverted name for	Bidayuh, Biatah	Biatah Bidayuh
bth, Name for	Biatah Bidayuh	Biatah Bidayuh
bti, Name for	Burate	Burate
btj, Inverted name for	Malay, Bacanese	Bacanese Malay
btj, Name for	Bacanese Malay	Batjan Maleis
btm, Name for	Batak Mandailing	Batak Mandailing
btn, Name for	Ratagnon	Ratagnon
btp, Name for	Budibud	Budibud
btq, Name for	Batek	Batek
btr, Name for	Baetora	Baetora
bts, Name for	Batak Simalungun	Batak Simalungun
btt, Name for	Bete-Bendi	Bete-Bendi
btu, Name for	Batu	Batu
btv, Name for	Bateri	Bateri
btw, Name for	Butuanon	Butuanon
btx, Name for	Batak Karo	Batak Karo
bty, Name for	Bobot	Bobot
btz, Name for	Batak Alas-Kluet	Batak Alas-Kluet
bua, Name for	Buriat	Boerjatisch
bub, Name for	Bua	Bua
buc, Name for	Bushi	Bushi
bud, Name for	Ntcham	Ntcham
bue, Name for	Beothuk	Beothuk
buf, Name for	Bushoong	Bushoong
bug, Name for	Buginese	Buginees
buh, Inverted name for	Bunu, Younuo	Younuo Bunu
buh, Name for	Younuo Bunu	Younuo Bunu
bui, Name for	Bongili	Bongili
buj, Name for	Basa-Gurmana	Basa-Gurmana
buk, Name for	Bugawac	Bugawac
bul, Name for	Bulgarian	Bulgaars
bum, Name for	Bulu (Cameroon)	Bulu (Cameroen)
bun, Name for	Sherbro	Sherbro
buo, Name for	Terei	Terei
bup, Name for	Busoa	Busoa
buq, Name for	Brem	Brem
bus, Name for	Bokobaru	Bokobaru
but, Name for	Bungain	Bungain
buw, Name for	Bubi	Bubi
buz, Name for	Bukwen	Bukwen
bva, Name for	Barein	Barein
bvb, Name for	Bube	Bube
bvc, Name for	Baelelea	Baelelea
bvh, Name for	Bure	Bure
bvj, Name for	Baan	Baan
bvk, Name for	Bukat	Bukat
bvl, Name for	Bolivian Sign Language	Boliviaanse Gebarentaal
bvm, Name for	Bamunka	Bamunka
bvn, Name for	Buna	Buna
bvo, Name for	Bolgo	Bolgo
bvp, Name for	Bumang	Bumang
bvq, Name for	Birri	Birri
bvr, Name for	Burarra	Burarra
bvt, Name for	Bati (Indonesia)	Bati (Indonesië)
bvu, Name for	Bukit Malay	Bukit Maleis
bvv, Name for	Baniva	Baniva
bvw, Name for	Boga	Boga
bvy, Name for	Baybayanon	Baybayanon
bvz, Name for	Bauzi	Bauzi
bwc, Name for	Bwile	Bwile
bwd, Name for	Bwaidoka	Bwaidoka
bwe, Inverted name for	Karen, Bwe	Bwe Karen
bwg, Name for	Barwe	Barwe
bwi, Name for	Baniwa	Baniwa
bwk, Name for	Bauwaki	Bauwaki
bwl, Name for	Bwela	Bwela
bwm, Name for	Biwat	Biwat
bwp, Name for	Mandobo Bawah	Mandobo Bawah
bwq, Inverted name for	Bobo Madaré, Southern	Bobo Madaré, Zuidelijk
bws, Name for	Bomboma	Bomboma
bwz, Name for	Bwisi	Bwisi
bxa, Name for	Tairaha	Tairaha
bxb, Inverted name for	Bor, Belanda	Bor, Belanda
bxb, Name for	Belanda Bor	Belanda Bor
bxc, Name for	Molengue	Molengue
bxe, Name for	Birale	Birale
bxf, Name for	Bilur	Bilur
bxg, Name for	Bangala	Bangala
bxk, Name for	Bukusu	Bukusu
bxl, Name for	Jalkunan	Jalkunan
bxm, Inverted name for	Buriat, Mongolia	Boerjatisch, Mongools
bxm, Name for	Mongolia Buriat	Mongools Boerjatisch
bxn, Name for	Burduna	Burduna
bxo, Name for	Barikanchi	Barikanchi
bxp, Name for	Bebil	Bebil
bxr, Inverted name for	Buriat, Russia	Boerjatisch, Russisch
bxr, Name for	Russia Buriat	Russisch Boerjatisch
bxs, Name for	Busam	Busam
bxu, Inverted name for	Buriat, China	Boerjatisch, Chinees
bxu, Name for	China Buriat	Chinees Boerjatisch
bxz, Name for	Binahari	Binahari
bya, Name for	Batak	Batak
byb, Name for	Bikya	Bikya
byc, Name for	Ubaghara	Ubaghara
bye, Name for	Pouye	Pouye
byf, Name for	Bete	Bete
byg, Name for	Baygo	Baygo
byh, Name for	Bhujel	Bhujel
byi, Name for	Buyu	Buyu
byk, Name for	Biao	Biao
byl, Name for	Bayono	Bayono
bym, Name for	Bidyara	Bidyara
byn, Name for	Bilin	Bilin
byo, Name for	Biyo	Biyo
byp, Name for	Bumaji	Bumaji
byq, Name for	Basay	Basay
byr, Name for	Baruya	Baruya
bys, Name for	Burak	Burak
byt, Name for	Berti	Berti
byv, Name for	Medumba	Medumba
byw, Name for	Belhariya	Belhariya
byx, Name for	Qaqet	Qaqet
byz, Name for	Banaro	Banaro
bza, Name for	Bandi	Bandi
bzb, Name for	Andio	Andio
bzd, Name for	Bribri	Bribri
bze, Inverted name for	Bozo, Jenaama	Bozo, Jenaama
bzf, Name for	Boikin	Boikin
bzg, Name for	Babuza	Babuza
bzh, Inverted name for	Buang, Mapos	Buang, Mapos
bzi, Name for	Bisu	Bisu
bzj, Inverted name for	Kriol English, Belize	Creools Engels, Belizaans
bzj, Name for	Belize Kriol English	Belizaans Creools Engels
bzk, Inverted name for	Creole English, Nicaragua	Engels Creools, Nicaragua
bzm, Name for	Bolondo	Bolondo
bzo, Name for	Bozaba	Bozaba
bzp, Name for	Kemberano	Kemberano
bzq, Name for	Buli (Indonesia)	Buli (Indonesië)
bzr, Name for	Biri	Biri
bzs, Name for	Brazilian Sign Language	Braziliaanse Gebarentaal
bzt, Name for	Brithenig	Brithenig
bzu, Name for	Burmeso	Burmeso
bzv, Name for	Naami	Naami
bzw, Name for	Basa (Nigeria)	Basa (Nigeria)
bzy, Name for	Obanliku	Obanliku
bzz, Name for	Evant	Evant
caa, Name for	Chortí	Chortí
cab, Name for	Garifuna	Garifuna
cac, Name for	Chuj	Chuj
cad, Name for	Caddo	Caddo
cae, Name for	Lehar	Laalaa
caf, Inverted name for	Carrier, Southern	Zuid-Carrier
cag, Name for	Nivaclé	Nivaclé
cah, Name for	Cahuarano	Cahuarano
caj, Name for	Chané	Chané
cak, Name for	Kaqchikel	Kaqchikel
cal, Name for	Carolinian	Carolinian
cam, Name for	Cemuhî	Cemuhî
can, Name for	Chambri	Chambri
cao, Name for	Chácobo	Chácobo
cap, Name for	Chipaya	Chipaya
car, Name for	Galibi Carib	Caribische talen
cas, Name for	Tsimané	Tsimané
cat, Name for	Catalan	Catalaans
cav, Name for	Cavineña	Cavineña
caw, Name for	Callawalla	Callawalla
cax, Name for	Chiquitano	Chiquitano
cay, Name for	Cayuga	Cayuga
caz, Name for	Canichana	Canichana
cbb, Name for	Cabiyarí	Cabiyarí
cbc, Name for	Carapana	Carapana
cbd, Name for	Carijona	Carijona
cbg, Name for	Chimila	Chimila
cbi, Name for	Chachi	Chachi
cbk, Name for	Chavacano	Chavacano
cbl, Name for	Bualkhaw Chin	Bualkhaw Chin
cbn, Name for	Nyahkur	Nyah-Kur
cbo, Name for	Izora	Izora
cbs, Name for	Cashinahua	Cashinahua
cbt, Name for	Chayahuita	Chayahuita
cbv, Name for	Cacua	Cacua
cbw, Name for	Kinabalian	Kinabalian
cby, Name for	Carabayo	Carabayo
cca, Name for	Cauca	Cauca
ccc, Name for	Chamicuro	Chamicuro
cce, Name for	Chopi	Chopi
ccg, Inverted name for	Daka, Samba	Samba Daka
ccg, Name for	Samba Daka	Samba Daka
cch, Name for	Atsam	Atsam
ccj, Name for	Kasanga	Kasanga
ccl, Name for	Cutchi-Swahili	Cutchi-Swahili
ccm, Name for	Malaccan Creole Malay	Malakka Creools Maleis
ccp, Name for	Chakma	Chakma
ccr, Name for	Cacaopera	Cacaopera
cda, Name for	Choni	Choni
cde, Name for	Chenchu	Chenchu
cdf, Name for	Chiru	Chiru
cdg, Name for	Chamari	Chamari
cdh, Name for	Chambeali	Chambeali
cdi, Name for	Chodri	Chodri
cdj, Name for	Churahi	Churahi
cdm, Name for	Chepang	Chepang
cdn, Name for	Chaudangsi	Chaudangsi
cdo, Name for	Min Dong Chinese	Min Dong Chinees
cds, Name for	Chadian Sign Language	Tsjaadse Gebarentaal
cdy, Name for	Chadong	Chadong
cdz, Name for	Koda	Koda
ceb, Name for	Cebuano	Cebuano
ceg, Name for	Chamacoco	Chamacoco
cek, Inverted name for	Chin, Eastern Khumi	Chin, Oost-Khumi
cek, Name for	Eastern Khumi Chin	Oost-Khumi Chin
cen, Name for	Cen	Cen
ces, Name for	Czech	Tsjechisch
cet, Name for	Centúúm	Centúúm
cfa, Name for	Dijim-Bwilim	Dijim-Bwilim
cfd, Name for	Cara	Cara
cfm, Name for	Falam Chin	Falam Chin
cgg, Name for	Chiga	Chiga
cha, Name for	Chamorro	Chamorro
chb, Name for	Chibcha	Tsjibtsja
chc, Name for	Catawba	Catawba
che, Name for	Chechen	Tsjetsjeens
chg, Name for	Chagatai	Chagatai
chh, Name for	Chinook	Chinook
chk, Name for	Chuukese	Chuukees
chm, Name for	Mari (Russia)	Mari (Russisch)
chn, Name for	Chinook jargon	Chinook-jargon
cho, Name for	Choctaw	Choctaw
chp, Name for	Chipewyan	Chipewyaans
chr, Name for	Cherokee	Cherokee
chu, Name for	Church Slavic	Kerkelijk Slavisch
chv, Name for	Chuvash	Tsjoevasjisch
chx, Name for	Chantyal	Chantyal
chy, Name for	Cheyenne	Cheyenne
cic, Name for	Chickasaw	Chickasaw
cie, Name for	Cineni	Cineni
cik, Name for	Chitkuli Kinnauri	Chitkuli Kinnauri
cim, Name for	Cimbrian	Cimbrian
cip, Name for	Chiapanec	Chiapanec
cir, Name for	Tiri	Tiri
ciw, Name for	Chippewa	Chippewa
ciy, Name for	Chaima	Chaima
cja, Name for	Western Cham	West-Cham
cji, Name for	Chamalal	Chamalal
cjk, Name for	Chokwe	Chokwe
cjn, Name for	Chenapian	Chenapian
cjs, Name for	Shor	Shor
cjv, Name for	Chuave	Chuave
cjy, Inverted name for	Chinese, Jinyu	Chinees, Jinyu
cjy, Name for	Jinyu Chinese	Jinyu-Chinees
ckb, Inverted name for	Kurdish, Central	Koerdisch, Centraal
ckb, Name for	Central Kurdish	Centraal-Koerdisch
ckh, Name for	Chak	Chak
ckt, Name for	Chukot	Tsjoektsjisch
cku, Name for	Koasati	Coushatta
ckv, Name for	Kavalan	Kavalaans
cla, Name for	Ron	Ron
cli, Name for	Chakali	Chakali
clm, Name for	Clallam	Klallam
clu, Name for	Caluyanun	Caluyanun
cma, Name for	Maa	Maa
cme, Name for	Cerma	Cerma
cmg, Inverted name for	Mongolian, Classical	Mongools, Klassiek
cmg, Name for	Classical Mongolian	Klassiek Mongools
cmo, Name for	Central Mnong	Centraal-Santali
cns, Name for	Central Asmat	Centraal-Santali
cof, Name for	Colorado	Colorado
com, Name for	Comanche	Comanche
cop, Name for	Coptic	Koptisch
cor, Name for	Cornish	Cornish
cos, Name for	Corsican	Corsicaans
cpi, Inverted name for	Pidgin English, Chinese	Pidginengels, Chinees
cpi, Name for	Chinese Pidgin English	Chinees Pidginengels
cre, Name for	Cree	Cree
crs, Inverted name for	Creole French, Seselwa	Frans, Seychellencreools
crs, Name for	Seselwa Creole French	Seychellencreools Frans
csb, Name for	Kashubian	Kasjoebiaans
cse, Name for	Czech Sign Language	Tsjechische Gebarentaal
csf, Name for	Cuba Sign Language	Cubaanse Gebarentaal
csg, Name for	Chilean Sign Language	Chileense Gebarentaal
csl, Name for	Chinese Sign Language	Chinese Gebarentaal
csq, Name for	Croatia Sign Language	Kroatische Gebarentaal
cym, Name for	Welsh	Welsh
dak, Name for	Dakota	Dakota
dan, Name for	Danish	Deens
dar, Name for	Dargwa	Dargwa
dbj, Name for	Ida'an	Ida'aans
del, Name for	Delaware	Delaware
den, Name for	Slave (Athapascan)	Slavisch (Athapascaans)
deu, Name for	German	Duits
dgr, Name for	Dogrib	Dogrib
din, Name for	Dinka	Dinka
dlm, Name for	Dalmatian	Dalmatisch
doh, Name for	Dong	Vietnamese dong
dsb, Inverted name for	Sorbian, Lower	Sorbisch, Neder
dsb, Name for	Lower Sorbian	Nedersorbisch
dse, Name for	Dutch Sign Language	Nederlandse Gebarentaal
dsi, Name for	Disa	Disa
dsl, Name for	Danish Sign Language	Deense Gebarentaal
dso, Name for	Desiya	Desiya
dua, Name for	Duala	Duala
dum, Inverted name for	Dutch, Middle (ca. 1050-1350)	Nederlands, Middel (ca. 1050-1350)
dum, Name for	Middle Dutch (ca. 1050-1350)	Middelnederlands (ca. 1050-1350)
dyu, Name for	Dyula	Dyula
dzo, Name for	Dzongkha	Dzongkha
ebu, Name for	Embu	Embu
efi, Name for	Efik	Efikisch
egy, Name for	Egyptian (Ancient)	Egyptisch (Oud)
eka, Name for	Ekajuk	Ekajuk
ell, Inverted name for	Greek, Modern (1453-)	Grieks, Modern (1453-)
elx, Name for	Elamite	Elamitisch
eng, Name for	English	Engels
enm, Inverted name for	English, Middle (1100-1500)	Engels, Middel (1100-1500)
enm, Name for	Middle English (1100-1500)	Middelengels (1100-1500)
enq, Name for	Enga	Enga
epo, Name for	Esperanto	Esperanto
esi, Inverted name for	Inupiatun, North Alaskan	Inupiatun, Noord-Alaskaans
esi, Name for	North Alaskan Inupiatun	Noord-Alaskaans Inupiatun
esk, Inverted name for	Inupiatun, Northwest Alaska	Inupiatun, Noordwest-Alaskaans
esk, Name for	Northwest Alaska Inupiatun	Noordwest-Alaskaans Inupiatun
esl, Name for	Egypt Sign Language	Egyptische Gebarentaal
eso, Name for	Estonian Sign Language	Estonische Gebarentaal
est, Name for	Estonian	Estlands
eus, Name for	Basque	Baskisch
ewe, Name for	Ewe	Ewe
ewo, Name for	Ewondo	Ewondo
fao, Name for	Faroese	Faeröers
fas, Name for	Persian	Perzisch
fat, Name for	Fanti	Fanti
fcs, Name for	Quebec Sign Language	Quebec Gebarentaal
fij, Name for	Fijian	Fijisch
fin, Name for	Finnish	Fins
fon, Name for	Fon	Fon
fra, Name for	French	Frans
frc, Inverted name for	French, Cajun	Frans, Cajun-
frc, Name for	Cajun French	Cajun-Frans
frk, Name for	Frankish	Frankisch
frm, Inverted name for	French, Middle (ca. 1400-1600)	Frans, Middel (ca. 1400-1600)
frm, Name for	Middle French (ca. 1400-1600)	Middelfrans (ca. 1400-1600)
fro, Inverted name for	French, Old (842-ca. 1400)	Frans, Oud (842-ca. 1400)
fro, Name for	Old French (842-ca. 1400)	Oudfrans (842-ca. 1400)
frr, Name for	Northern Frisian	Noord-Fries
frs, Name for	Eastern Frisian	Oost-Fries
fse, Name for	Finnish Sign Language	Finse Gebarentaal
fsl, Name for	French Sign Language	Franse Gebarentaal
fss, Name for	Finland-Swedish Sign Language	Fins-Zweedse Gebarentaal
ful, Name for	Fulah	Fulah
fur, Name for	Friulian	Friulisch
gaa, Name for	Ga	Ga
gay, Name for	Gayo	Gayo
gcc, Name for	Mali	Mali
gcf, Inverted name for	Creole French, Guadeloupean	Frans, Guadeloups Creools
gcf, Name for	Guadeloupean Creole French	Guadeloups Creools Frans
gcr, Inverted name for	Creole French, Guianese	Frans, Guyaans Creool
gcr, Name for	Guianese Creole French	Guyaans Creools Frans
gct, Inverted name for	German, Colonia Tovar	Duits, Colonia Tovar (Alemán Coloniero)
gct, Name for	Colonia Tovar German	Colonia Tovar Duits (Alemán Coloniero)
gds, Name for	Ghandruk Sign Language	Ghandruk Gebarentaal
gea, Name for	Geruma	Geruma
geh, Inverted name for	German, Hutterite	Duits, Hutterisch
geh, Name for	Hutterite German	Hutterisch Duits
gej, Name for	Gen	Gen
gew, Name for	Gera	Gera
gez, Name for	Geez	Geez
gga, Name for	Gao	Gao
ghr, Name for	Ghera	Ghera
gil, Name for	Gilbertese	Gilbertees
gis, Inverted name for	Giziga, North	Giziga, Noord
gis, Name for	North Giziga	Noord-Giziga
giz, Inverted name for	Giziga, South	Giziga, Zuid
giz, Name for	South Giziga	Zuid-Giziga
gle, Name for	Irish	Iers
glg, Name for	Galician	Galiciaans
glh, Inverted name for	Pashai, Northwest	Pashai, Noordoostelijk
glh, Name for	Northwest Pashai	Noordoostelijk Pashai
glu, Name for	Gula (Chad)	Gula (Tsjaad)
glv, Name for	Manx	Manx
gmh, Inverted name for	German, Middle High (ca. 1050-1500)	Duits, Middelhoog (ca. 1050-1500)
gmh, Name for	Middle High German (ca. 1050-1500)	Middelhoogduits (ca. 1050-1500)
gml, Inverted name for	German, Middle Low	Duits, Middellaag
gml, Name for	Middle Low German	Middellaagduits
gmm, Name for	Gbaya-Mbodomo	Gbaya-Mbodomo
gmn, Name for	Gimnime	Gimnime
gmu, Name for	Gumalu	Gumalu
gmv, Name for	Gamo	Gamo
gmx, Name for	Magoma	Magoma
gmy, Inverted name for	Greek, Mycenaean	Myceens Grieks
gmy, Name for	Mycenaean Greek	Myceens Grieks
gmz, Name for	Mgbolizhia	Mgbolizhia
gna, Name for	Kaansa	Kaansa
gnb, Name for	Gangte	Gangte
gnc, Name for	Guanche	Guanche
gnd, Name for	Zulgo-Gemzek	Zulgo-Gemzek
gne, Name for	Ganang	Ganang
gng, Name for	Ngangam	Ngangam
gnh, Name for	Lere	Lere
gni, Name for	Gooniyandi	Gooniyandi
gnm, Name for	Ginuman	Ginuman
goh, Inverted name for	German, Old High (ca. 750-1050)	Duits, Oudhoog (ca. 750-1050)
goh, Name for	Old High German (ca. 750-1050)	Oudhoogduits (ca.750-1050)
gok, Name for	Gowli	Gowli
gol, Name for	Gola	Gola
gon, Name for	Gondi	Gondi
gor, Name for	Gorontalo	Gorontalo
got, Name for	Gothic	Gothisch
gpe, Inverted name for	Pidgin English, Ghanaian	Pidginengels, Ghanees
gpe, Name for	Ghanaian Pidgin English	Ghanees Pidginengels
grb, Name for	Grebo	Grebo
grc, Inverted name for	Greek, Ancient (to 1453)	Grieks, Oud (tot 1453)
grn, Name for	Guarani	Paraguaanse guarani
gro, Name for	Groma	Groma
grv, Inverted name for	Grebo, Central	Gorontalo, Centraal
gse, Name for	Ghanaian Sign Language	Ghanese Gebarentaal
gsg, Name for	German Sign Language	Duitse Gebarentaal
gss, Name for	Greek Sign Language	Griekse Gebarentaal
gsw, Inverted name for	German, Swiss	Duits, Zwitser
gsw, Name for	Swiss German	Zwitserduits
gug, Name for	Paraguayan Guaraní	Paraguayaans Guaraní
guj, Name for	Gujarati	Gujarati
gus, Name for	Guinean Sign Language	Guineese Gebarentaal
gve, Name for	Duwet	Duwet
gvm, Name for	Gurmana	Gurmana
gye, Name for	Gyem	Gyem
hab, Name for	Hanoi Sign Language	Hanoise Gebarentaal
haf, Name for	Haiphong Sign Language	Hai Phongse Gebarentaal
hai, Name for	Haida	Haida
haq, Name for	Ha	Ha
hau, Name for	Hausa	Hausa
haw, Name for	Hawaiian	Hawaiiaans
hds, Name for	Honduras Sign Language	Hondurese Gebarentaal
heb, Name for	Hebrew	Hebreeuws
her, Name for	Herero	Herero
hil, Name for	Hiligaynon	Hiligainoons
hin, Name for	Hindi	Hindi
hit, Name for	Hittite	Hittitisch
hks, Name for	Hong Kong Sign Language	Hongkongse Gebarentaal
hmj, Name for	Ge	Ge
hmn, Name for	Hmong	Hmong
hmo, Name for	Hiri Motu	Hiri Motu
hps, Name for	Hawai'i Sign Language (HSL)	Hawaïaanse Gebarentaal
hrv, Name for	Croatian	Kroatisch
hsb, Name for	Upper Sorbian	Oppersorbisch
hsh, Name for	Hungarian Sign Language	Hongaarse Gebarentaal
hun, Name for	Hungarian	Hongaars
hup, Name for	Hupa	Hupa
hye, Name for	Armenian	Armeens
iba, Name for	Iban	Ibaans
ibl, Name for	Ibaloi	Ibaloi
ibo, Name for	Igbo	Igbo
icl, Name for	Icelandic Sign Language	IJslandse Gebarentaal
ido, Name for	Ido	Ido
ign, Name for	Ignaciano	Ignaciano
iku, Name for	Inuktitut	Inuktitut
ilb, Name for	Ila	Ila
ile, Name for	Interlingue	Interlingue
ilo, Name for	Iloko	Iloko
ina, Name for	Interlingua (International Auxiliary Language Association)	Interlingua (International Auxiliary Language Association)
ind, Name for	Indonesian	Indonesisch
inh, Name for	Ingush	Ingoesjetisch
inl, Name for	Indonesian Sign Language	Indonesische Gebarentaal
ins, Name for	Indian Sign Language	Indiaanse Gebarentaal
ipk, Name for	Inupiaq	Inupiak
iqu, Name for	Iquito	Iquito
ise, Name for	Italian Sign Language	Italiaanse Gebarentaal
isg, Name for	Irish Sign Language	Ierse Gebarentaal
isl, Name for	Icelandic	IJslands
isr, Name for	Israeli Sign Language	Israëlische Gebarentaal
ita, Name for	Italian	Italiaans
itk, Name for	Judeo-Italian	Judeo-Italiaans
itv, Name for	Itawit	Itawit
jav, Name for	Javanese	Javaans
jbo, Name for	Lojban	Lojbaans
jhi, Name for	Jehai	Jehai
jib, Name for	Jibu	Jibu
jid, Name for	Bu	Buh
jie, Name for	Jilbe	Jilbe
jig, Name for	Djingili	Djingili
jit, Name for	Jita	Jita
jiv, Name for	Shuar	Shuar
jkm, Name for	Mobwa Karen	Mobwa Karen
jls, Name for	Jamaican Sign Language	Jamaicaanse Gebarentaal
jpn, Name for	Japanese	Japans
jpr, Name for	Judeo-Persian	Judeo-Perzisch
jrb, Name for	Judeo-Arabic	Judeo-Arabisch
jsl, Name for	Japanese Sign Language	Japanse Gebarentaal
juc, Name for	Jurchen	Jurchen
kaa, Name for	Kara-Kalpak	Kara-Kalpak
kab, Name for	Kabyle	Kabyle
kac, Name for	Kachin	Kachin
kan, Name for	Kannada	Kannada
kas, Name for	Kashmiri	Kashmiri
kat, Name for	Georgian	Georgisch
kau, Name for	Kanuri	Kanuri
kaw, Name for	Kawi	Kawi
kaz, Name for	Kazakh	Kazachs
kbv, Name for	Dera (Indonesia)	Dera (Indonesië)
kcp, Name for	Kanga	Kannada, Kanara Kanarees
kcu, Name for	Kami (Tanzania)	Kami (Tanzania)
kfe, Name for	Kota (India)	Kota (Indonesië)
kgv, Name for	Karas	Karas
kha, Name for	Khasi	Khasi
khm, Inverted name for	Khmer, Central	Khmer, Centraal
khm, Name for	Central Khmer	Centraal-Khmer
kho, Name for	Khotanese	Khotanees
kik, Name for	Kikuyu	Kikuyu
kin, Name for	Kinyarwanda	Kinyarwanda
kir, Name for	Kirghiz	Kirgizisch
kiu, Name for	Kirmanjki (individual language)	Kirmanjki (individuele taal)
kmb, Name for	Kimbundu	Kimbundu
kmd, Inverted name for	Kalinga, Majukayang	Kalinga, Majukayang
kmd, Name for	Majukayang Kalinga	Majukayang Kalinga
kmk, Inverted name for	Kalinga, Limos	Kalinga, Limos
kmk, Name for	Limos Kalinga	Limos Kalinga
kml, Inverted name for	Kalinga, Tanudan	Kalinga, Tanudan
kml, Name for	Tanudan Kalinga	Tanudan Kalinga
kmv, Inverted name for	Creole French, Karipúna	Frans, Karipúna-Creools
kmv, Name for	Karipúna Creole French	Karipúna-Creools Frans
knb, Inverted name for	Kalinga, Lubuagan	Kalinga, Lubuagan
knb, Name for	Lubuagan Kalinga	Lubuagan Kalinga
knc, Name for	Central Kanuri	Centraal-Kanuri
knn, Name for	Konkani (individual language)	Konkani (individuele taal)
kom, Name for	Komi	Komi
kon, Name for	Kongo	Kongo
kor, Name for	Korean	Koreaans
kos, Name for	Kosraean	Kosraeaans
kpe, Name for	Kpelle	Kpelle
kqs, Inverted name for	Kissi, Northern	Kissi, Noord
kqs, Name for	Northern Kissi	Noord-Kissi
krc, Name for	Karachay-Balkar	Karatsjay-Balkar
krh, Name for	Kurama	Kurama
kri, Name for	Krio	Krio
krl, Name for	Karelian	Karelisch
kru, Name for	Kurukh	Kurukh
ksc, Inverted name for	Kalinga, Southern	Kalinga, Zuid
ksc, Name for	Southern Kalinga	Zuid-Kalinga
ksr, Name for	Borong	Borong
kua, Name for	Kuanyama	Kuanyama
kum, Name for	Kumyk	Kumyk
kur, Name for	Kurdish	Koerdisch
kut, Name for	Kutenai	Kutenaïsch
kvd, Name for	Kui (Indonesia)	Kui (Indonesië)
kvk, Name for	Korean Sign Language	Koreaanse Gebarentaal
kvt, Name for	Lahta Karen	Lahta Karen
kxl, Inverted name for	Kurux, Nepali	Kurux, Nepalees
kxm, Inverted name for	Khmer, Northern	Khmer, Noord
kxm, Name for	Northern Khmer	Noord-Khmer
lab, Name for	Linear A	Lineair A
lad, Name for	Ladino	Ladino
lae, Name for	Pattani	Pattani
lah, Name for	Lahnda	Lahnda
lam, Name for	Lamba	Lamba
lao, Name for	Lao	Lao
lap, Name for	Laka (Chad)	Laka (Tsjaad)
lat, Name for	Latin	Latijn
lav, Name for	Latvian	Lets
lbk, Inverted name for	Bontok, Central	Santali, Centraal
lbk, Name for	Central Bontok	Centraal-Bontok
lbs, Name for	Libyan Sign Language	Lybische Gebarentaal
lcd, Name for	Lola	Lola
lez, Name for	Lezghian	Lezghiaans
lhh, Name for	Laha (Indonesia)	Laha (Indonesië)
lif, Name for	Limbu	Limbu
lin, Name for	Lingala	Lingala
lir, Name for	Liberian English	Liberiaans Engels
lit, Name for	Lithuanian	Litouws
llh, Name for	Lamu	Lamu
lln, Name for	Lele (Chad)	Lele (Tsjaad)
lls, Name for	Lithuanian Sign Language	Litouwse Gebarentaal
lol, Name for	Mongo	Mongo
loz, Name for	Lozi	Lozi
lrl, Name for	Lari	Georgische lari
lsg, Name for	Lyons Sign Language	Lyonse Gebarentaal
lsl, Name for	Latvian Sign Language	Letse Gebarentaal
lsp, Name for	Panamanian Sign Language	Panamase Gebarentaal
lst, Name for	Trinidad and Tobago Sign Language	Trinidad en Tobago Gebarentaal
lsy, Name for	Mauritian Sign Language	Mauritaanse Gebarentaal
lti, Name for	Leti (Indonesia)	Leti (Indonesië)
lua, Name for	Luba-Lulua	Luba-Lulua
lub, Name for	Luba-Katanga	Luba-Katanga
lug, Name for	Ganda	Ganda
lui, Name for	Luiseno	Luiseno
lun, Name for	Lunda	Lunda
luo, Name for	Luo (Kenya and Tanzania)	Luo (Kenia en Tanzania)
lus, Name for	Lushai	Lushai
luw, Name for	Luo (Cameroon)	Luo (Kameroen)
mad, Name for	Madurese	Madurees
mag, Name for	Magahi	Magahisch
mah, Name for	Marshallese	Marshallees
mai, Name for	Maithili	Maithili
mak, Name for	Makasar	Makasar
mal, Name for	Malayalam	Malayalam
man, Name for	Mandingo	Mandingo
mar, Name for	Marathi	Marathi
mas, Name for	Masai	Masai
maz, Inverted name for	Mazahua, Central	Nahuatl, Centraal
maz, Name for	Central Mazahua	Centraal-Santali
mcw, Name for	Mawa (Chad)	Mawa (Tsjaad)
mde, Name for	Maba (Chad)	Maba (Tsjaad)
mdf, Name for	Moksha	Moksja
mdl, Name for	Maltese Sign Language	Maltese Gebarentaal
mdr, Name for	Mandar	Mandars
mec, Name for	Mara	Mara
mel, Name for	Central Melanau	Centraal-Santali
mer, Name for	Meru	Meru
mfs, Name for	Mexican Sign Language	Mexicaanse Gebarentaal
mfy, Name for	Mayo	Mayo
mga, Inverted name for	Irish, Middle (900-1200)	Iers, Middel (900-1200)
mga, Name for	Middle Irish (900-1200)	Middeliers (900-1200)
mgs, Name for	Manda (Tanzania)	Mandra (Tanzania)
mha, Name for	Manda (India)	Manda (India)
mhs, Name for	Buru (Indonesia)	Buru (Indonesië)
mhz, Name for	Mor (Mor Islands)	Mor (Moreilanden)
min, Name for	Minangkabau	Minangkabau
mis, Name for	Uncoded languages	Niet-gecodeerde talen
mjh, Name for	Mwera (Nyasa)	Mwera (Nyasa)
mkd, Name for	Macedonian	Macedonisch
mlg, Name for	Malagasy	Malagassisch
mlt, Name for	Maltese	Maltees
mnc, Name for	Manchu	Manchu
mni, Name for	Manipuri	Manipuri
mnw, Name for	Mon	Mon
moh, Name for	Mohawk	Mohawk
mon, Name for	Mongolian	Mongools
mos, Name for	Mossi	Mossisch
mpk, Name for	Mbara (Chad)	Mbara (Tsjaad)
mqa, Name for	Maba (Indonesia)	Maba (Indonesië)
mri, Name for	Maori	Maori
mrr, Name for	Maria (India)	Maria (India)
msr, Name for	Mongolian Sign Language	Mongoolse Gebarentaal
mtn, Name for	Matagalpa	Matagalpa
mul, Name for	Multiple languages	Meerdere talen
mus, Name for	Creek	Creek
mvw, Name for	Machinga	Machinga
mwl, Name for	Mirandese	Mirandees
mwr, Name for	Marwari	Marwari
mxn, Name for	Moi (Indonesia)	Moi (Indonesië)
mya, Name for	Burmese	Burmees
myi, Name for	Mina (India)	Mina (India)
myv, Name for	Erzya	Erzya
mzg, Name for	Monastic Sign Language	Monastische Gebarentaal
nap, Name for	Neapolitan	Napolitaans
nau, Name for	Nauru	Nauru
nbl, Inverted name for	Ndebele, South	Ndebele, Zuid
nbl, Name for	South Ndebele	Zuid-Ndebele
ncs, Name for	Nicaraguan Sign Language	Nicaraguaanse Gebarentaal
nde, Inverted name for	Ndebele, North	Ndebele, Noord
nde, Name for	North Ndebele	Ndebele-Noord
ndo, Name for	Ndonga	Ndonga
nds, Inverted name for	German, Low	Duits, Laag
nds, Name for	Low German	Laagduits
neg, Name for	Negidal	Negidal
ner, Name for	Yahadian	Yahadian
ney, Name for	Neyo	Neyo
nfa, Name for	Dhao	Dhao
nge, Name for	Ngemba	Ngemba
ngi, Name for	Ngizim	Ngizim
nia, Name for	Nias	Niaas
nih, Name for	Nyiha (Tanzania)	Nyiha (Tanzania)
nil, Name for	Nila	Nila
nim, Name for	Nilamba	Nilamba
nio, Name for	Nganasan	Nganasan
niq, Name for	Nandi	Nandi
nir, Name for	Nimboran	Nimboran
nis, Name for	Nimi	Nimi
nit, Inverted name for	Kolami, Southeastern	Kolami, Zuidoostelijk
nit, Name for	Southeastern Kolami	Zuidoostelijk Kolami
niu, Name for	Niuean	Niueaans
niw, Name for	Nimo	Nimo
nix, Name for	Hema	Hema
niy, Name for	Ngiti	Ngiti
niz, Name for	Ningil	Ningil
nji, Name for	Gudanji	Gudanji
njm, Name for	Angami Naga	Angami Naga
njn, Name for	Liangmai Naga	Liangmai Naga
njs, Name for	Nisa	Nisa
njx, Name for	Kunyi	Kunyi
njz, Name for	Nyishi	Nyishi
nka, Name for	Nkoya	Nkoya
nkc, Name for	Nkongho	Nkongho
nkd, Name for	Koireng	Koireng
nkg, Name for	Nekgini	Nekgini
nki, Name for	Thangal Naga	Thangal Naga
nkj, Name for	Nakai	Nakai
nkm, Name for	Namat	Namat
nkn, Name for	Nkangala	Nkangala
nko, Name for	Nkonya	Nkonya
nkq, Name for	Nkami	Nkami
nkr, Name for	Nukuoro	Nukuoro
nkt, Name for	Nyika (Tanzania)	Nyika (Tanzania)
nku, Name for	Bouna Kulango	Bouna Kulango
nkw, Name for	Nkutu	Nkutu
nkx, Name for	Nkoroo	Nkoroo
nkz, Name for	Nkari	Nkari
nlc, Name for	Nalca	Nalca
nld, Name for	Dutch	Nederlands
nno, Name for	Norwegian Nynorsk	Noors Nynorsk
nob, Name for	Norwegian Bokmål	Noors Bokmål
nod, Inverted name for	Thai, Northern	Thai, Noord
nog, Name for	Nogai	Nogai
non, Inverted name for	Norse, Old	Noors, Oud
nor, Name for	Norwegian	Noors
nqo, Name for	N'Ko	Nko
nrb, Name for	Nara	Nara
nsi, Name for	Nigerian Sign Language	Nigeriaanse Gebarentaal
nsp, Name for	Nepalese Sign Language	Nepalese Gebarentaal
nsr, Name for	Maritime Sign Language	Maritieme Gebarentaal
nyf, Name for	Giryama	Giryama
nyj, Name for	Nyanga	Nyanga
nym, Name for	Nyamwezi	Nyamwezi
nyn, Name for	Nyankole	Nyankools
nyo, Name for	Nyoro	Nyoro
nzi, Name for	Nzima	Nzima
nzs, Name for	New Zealand Sign Language	Nieuw-Zeelandse Gebarentaal
oar, Inverted name for	Aramaic, Old (up to 700 BCE)	Aramees, Oud (tot 700 v.Chr.)
oar, Name for	Old Aramaic (up to 700 BCE)	Oudaramees (tot 700 v.Chr.)
oav, Inverted name for	Avar, Old	Avaars, Oud
oav, Name for	Old Avar	Oudavaars
obt, Inverted name for	Breton, Old	Bretons, Oud
obt, Name for	Old Breton	Oudbretons
oci, Name for	Occitan (post 1500)	Occitaans (na 1500)
odt, Inverted name for	Dutch, Old	Nederlands, Oud
odt, Name for	Old Dutch	Oudnederlands
oge, Inverted name for	Georgian, Old	Georgisch, Oud
oge, Name for	Old Georgian	Oudgeorgisch
ohu, Name for	Old Hungarian	Oudhongaars
oji, Name for	Ojibwa	Ojibwa
okl, Inverted name for	Kentish Sign Language, Old	Kentische Gebarentaal
okl, Name for	Old Kentish Sign Language	Oudkeltische Gebarentaal
okm, Inverted name for	Korean, Middle (10th-16th cent.)	Koreaans, Middel (10e-16e eeuw)
okm, Name for	Middle Korean (10th-16th cent.)	Middelkoreaans (10e-16e eeuw)
oko, Inverted name for	Korean, Old (3rd-9th cent.)	Koreaans, Oud (3e-9e eeuw)
oko, Name for	Old Korean (3rd-9th cent.)	Oudkoreaans (3e-9e eeuw)
omx, Inverted name for	Mon, Old	Mon, Oud
oos, Inverted name for	Ossetic, Old	Ossetisch
orm, Name for	Oromo	Oromo
ort, Inverted name for	Oriya, Adivasi	Odia, Adivasi
osa, Name for	Osage	Osage
osx, Inverted name for	Saxon, Old	Saksisch, Oud
ota, Inverted name for	Turkish, Ottoman (1500-1928)	Turks, Ottomaans (1500-1928)
ota, Name for	Ottoman Turkish (1500-1928)	Ottomaans Turks (1500-1928)
oui, Inverted name for	Uighur, Old	Oeigoers, Oud; Oejgoers, Oud
oui, Name for	Old Uighur	Oudoeigoers, Oudoejgoers
pag, Name for	Pangasinan	Pangasinaans
pal, Name for	Pahlavi	Pehlevi
pam, Name for	Pampanga	Pampanga
pap, Name for	Papiamento	Papiamento
pau, Name for	Palauan	Palauaans
pbv, Name for	Pnar	Pnar
pcb, Name for	Pear	Pear
pce, Inverted name for	Palaung, Ruching	Palauaans, Ruching
pce, Name for	Ruching Palaung	Ruching Palauaans
pcf, Name for	Paliyan	Paliyan
pcg, Name for	Paniya	Paniya
pch, Name for	Pardhan	Pardhan
pci, Name for	Duruwa	Duruwa
pcj, Name for	Parenga	Parenga
pck, Inverted name for	Chin, Paite	Chin, Paite
pck, Name for	Paite Chin	Paite Chin
pcl, Name for	Pardhi	Pardhi
pcm, Inverted name for	Pidgin, Nigerian	Pidgin, Nigeriaans
pcm, Name for	Nigerian Pidgin	Nigeriaans Pidgin
pcn, Name for	Piti	Piti
pcp, Name for	Pacahuara	Pacahuara
pcw, Name for	Pyapun	Pyapun
pda, Name for	Anam	Anam
pdc, Inverted name for	German, Pennsylvania	Duits, Pennsylvania-
pdc, Name for	Pennsylvania German	Pennsylvania-Duits
peo, Inverted name for	Persian, Old (ca. 600-400 B.C.)	Perzisch, Oud (ca. 600-400 v.Chr.)
peo, Name for	Old Persian (ca. 600-400 B.C.)	Oudperzisch (ca. 600-400 v.Chr.)
pep, Name for	Kunja	Kunja
pgl, Inverted name for	Irish, Primitive	Iers, Primitief
pgl, Name for	Primitive Irish	Primitief Iers
pgz, Name for	Papua New Guinean Sign Language	Papoea-Nieuw-Guineese Gebarentaal
phn, Name for	Phoenician	Fenicisch
pks, Name for	Pakistan Sign Language	Pakistaanse Gebarentaal
pli, Name for	Pali	Pali
pol, Name for	Polish	Pools
pon, Name for	Pohnpeian	Pohnpeiaans
por, Name for	Portuguese	Portugees
prf, Name for	Paranan	Paranan
prl, Name for	Peruvian Sign Language	Peruviaanse Gebarentaal
pro, Inverted name for	Provençal, Old (to 1500)	Provençaals, Oud (tot 1500)
psc, Name for	Persian Sign Language	Perzische Gebarentaal
psh, Inverted name for	Pashai, Southwest	Pashai, Noordoostelijk
psh, Name for	Southwest Pashai	Zuidwest-Pashai
psi, Inverted name for	Pashai, Southeast	Pashai, Noordoostelijk
psi, Name for	Southeast Pashai	Zuidoost-Pashai
pso, Name for	Polish Sign Language	Poolse Gebarentaal
psp, Name for	Philippine Sign Language	Filipijnse Gebarentaal
psr, Name for	Portuguese Sign Language	Portugese Gebarentaal
pus, Name for	Pushto	Poesjto
pys, Name for	Paraguayan Sign Language	Paraguayaanse Gebarentaal
que, Name for	Quechua	Quechua
raj, Name for	Rajasthani	Rajasthani
rap, Name for	Rapanui	Rapanui
rcf, Inverted name for	Creole French, Réunion	Frans, Réunions Creools
rcf, Name for	Réunion Creole French	Réunions Creools Frans
reg, Name for	Kara (Tanzania)	Kara (Tanzania)
ria, Name for	Riang (India)	Riang (India)
rki, Name for	Rakhine	Rakhine
rmc, Inverted name for	Romani, Carpathian	Romani, Karpatisch
rmc, Name for	Carpathian Romani	Karpatisch Romani
rmd, Inverted name for	Danish, Traveller	Romani, Deens
rmd, Name for	Traveller Danish	Deens Romani
rmg, Inverted name for	Norwegian, Traveller	Romani, Noors
rmg, Name for	Traveller Norwegian	Noors Romani
rml, Inverted name for	Romani, Baltic	Romani, Baltisch
rml, Name for	Baltic Romani	Baltisch Romani
rmm, Name for	Roma	Rome
rmn, Inverted name for	Romani, Balkan	Romani, Balkan
rmn, Name for	Balkan Romani	Balkan Romani
rmo, Inverted name for	Romani, Sinte	Romanes, Sinti-
rmo, Name for	Sinte Romani	Sinti-Romanes
rms, Name for	Romanian Sign Language	Roemeense Gebarentaal
rmu, Inverted name for	Romani, Tavringer	Romani, Scandinavisch
rmu, Name for	Tavringer Romani	Scandinavisch Romani
rmw, Inverted name for	Romani, Welsh	Romani, Wales
rmw, Name for	Welsh Romani	Wales Romani
rmy, Inverted name for	Romani, Vlax	Romani, Vlach
rmy, Name for	Vlax Romani	Vlach Romani
roh, Name for	Romansh	Romaans
rom, Name for	Romany	Roma
ron, Name for	Romanian	Roemeens
rsi, Name for	Rennellese Sign Language	Rennellese Gebarentaal
rsl, Name for	Russian Sign Language	Russische Gebarentaal
ruk, Name for	Che	Che
run, Name for	Rundi	Rundi
ruo, Inverted name for	Romanian, Istro	Roemeens, Istro-
ruo, Name for	Istro Romanian	Istro-Roemeens
rup, Inverted name for	Romanian, Macedo-	Roemeens, Macedo-
rup, Name for	Macedo-Romanian	Macedo-Roemeens
ruq, Inverted name for	Romanian, Megleno	Roemeens, Megleno-
ruq, Name for	Megleno Romanian	Megleno-Roemeens
rus, Name for	Russian	Russisch
rut, Name for	Rutul	Rutul
ruu, Inverted name for	Lobu, Lanas	Lobu, Lanas
ruy, Name for	Mala (Nigeria)	Mala (Nigeria)
ruz, Name for	Ruma	Ruma
rwa, Name for	Rawo	Rawo
rwk, Name for	Rwa	Rwa
rwr, Name for	Marwari (India)	Marwari (India)
saa, Name for	Saba	Saba
sad, Name for	Sandawe	Sandawe
sag, Name for	Sango	Sangho
sah, Name for	Yakut	Jakoets
sam, Name for	Samaritan Aramaic	Samaritaans Aramees
san, Name for	Sanskrit	Sanskriet
saq, Name for	Samburu	Samburu
sas, Name for	Sasak	Sasaaks
sat, Name for	Santali	Santali
saz, Name for	Saurashtra	Saurashtra
sbi, Name for	Seti	Seti
sbp, Name for	Sangu (Tanzania)	Sangu (Tanzania)
scf, Inverted name for	Creole French, San Miguel	Frans, San Miguel-Creools
scf, Name for	San Miguel Creole French	San Miguel-Creools Frans
scn, Name for	Sicilian	Siciliaans
sco, Name for	Scots	Schots
sel, Name for	Selkup	Sulkoeps
sga, Inverted name for	Irish, Old (to 900)	Iers, Oud (tot 900)
sga, Name for	Old Irish (to 900)	Oudiers (tot 900)
sgg, Name for	Swiss-German Sign Language	Zwitserduitse Gebarentaal
sgx, Name for	Sierra Leone Sign Language	Sierra Leoonse Gebarentaal
shn, Name for	Shan	Shan
shu, Inverted name for	Arabic, Chadian	Arabisch, Tsjaads
sid, Name for	Sidamo	Sidamo
sin, Name for	Sinhala	Sinhala
skw, Inverted name for	Creole Dutch, Skepi	Nederlands, Skepi Creools
skw, Name for	Skepi Creole Dutch	Skepi Creools Nederlands
slf, Name for	Swiss-Italian Sign Language	Zwitseritaliaanse Gebarentaal
sli, Inverted name for	Silesian, Lower	Silezisch, Laag
slk, Name for	Slovak	Slovaaks, Slowaaks
slv, Name for	Slovenian	Sloveens
smc, Name for	Som	Kirgizische som
smj, Name for	Lule Sami	Lule Sami
smn, Name for	Inari Sami	Inari Sami
smo, Name for	Samoan	Samoaans
smp, Name for	Samaritan	Samaritaans
sms, Name for	Skolt Sami	Skolt-Sami
sna, Name for	Shona	Shona
snd, Name for	Sindhi	Sindhi
snk, Name for	Soninke	Soninke
sog, Name for	Sogdian	Sogdiaans
som, Name for	Somali	Somali
sot, Inverted name for	Sotho, Southern	Sothaans, Zuid
sov, Name for	Sonsorol	Sonsorol
spa, Name for	Spanish	Spaans
spb, Name for	Sepa (Indonesia)	Sepa (Indonesië)
sqi, Name for	Albanian	Albanees
sqk, Name for	Albanian Sign Language	Albanese Gebarentaal
srd, Name for	Sardinian	Sardijns
srn, Name for	Sranan Tongo	Sranan Tongo
srp, Name for	Serbian	Servisch
srr, Name for	Serer	Serer
ssr, Name for	Swiss-French Sign Language	Zwitserfranse Gebarentaal
ssw, Name for	Swati	Swati
suk, Name for	Sukuma	Sukuma
sun, Name for	Sundanese	Soendanees
sus, Name for	Susu	Susu
sux, Name for	Sumerian	Sumerisch
swe, Name for	Swedish	Zweeds
swl, Name for	Swedish Sign Language	Zweedse Gebarentaal
syc, Name for	Classical Syriac	Klassiek Syrich
syr, Name for	Syriac	Syrisch
syy, Name for	Al-Sayyid Bedouin Sign Language	Al-Sayyid Bedouinse Gebarentaal
tah, Name for	Tahitian	Tahitisch
tak, Name for	Tala	Samoa tala
tam, Name for	Tamil	Tamil
tat, Name for	Tatar	Tatar
tbw, Name for	Tagbanwa	Tagbanwa
tel, Name for	Telugu	Telugu
tem, Name for	Timne	Timne
ter, Name for	Tereno	Tereno
tet, Name for	Tetum	Tetum
tgk, Name for	Tajik	Tadzjieks
tgl, Name for	Tagalog	Tagalog
tha, Name for	Thai	Thais
tig, Name for	Tigre	Tigre
tir, Name for	Tigrinya	Tigrinya
tiv, Name for	Tiv	Tiv
tkl, Name for	Tokelau	Tokelau
tli, Name for	Tlingit	Tlingit
tma, Name for	Tama (Chad)	Tama (Tsjaad)
tmh, Name for	Tamashek	Tamasjek
tmn, Name for	Taman (Indonesia)	Taman (Indonesië)
tmw, Name for	Temuan	Temuan
tog, Name for	Tonga (Nyasa)	Tonga (Nyasa)
toi, Name for	Tonga (Zambia)	Tonga (Zambia)
ton, Name for	Tonga (Tonga Islands)	Tonga (Tonga-eilanden)
tpi, Name for	Tok Pisin	Tok Pisin
trl, Inverted name for	Scottish, Traveller	Romani, Schots
trl, Name for	Traveller Scottish	Schots Romani
tse, Name for	Tunisian Sign Language	Tunisische Gebarentaal
tsi, Name for	Tsimshian	Tsimsjiaans
tsm, Name for	Turkish Sign Language	Turkse Gebarentaal
tsn, Name for	Tswana	Tswana
tso, Name for	Tsonga	Tsonga
tsq, Name for	Thai Sign Language	Thaise Gebarentaal
tss, Name for	Taiwan Sign Language	Taiwanese Gebarentaal
ttg, Name for	Tutong	Tutong
tuk, Name for	Turkmen	Turkmeens
tum, Name for	Tumbuka	Tumbuka
tur, Name for	Turkish	Turks
tuv, Name for	Turkana	Turkana
tvl, Name for	Tuvalu	Tuvalu
tvu, Name for	Tunen	Tunen
tvy, Inverted name for	Pidgin, Timor	Pidgin, Timorees
tvy, Name for	Timor Pidgin	Tomirees Pidgin
twe, Name for	Tewa (Indonesia)	Tewa (Indonesië)
twi, Name for	Twi	Twi
twu, Name for	Termanu	Termanu
txg, Name for	Tangut	Tangut
tyv, Name for	Tuvinian	Tuviniaans
tza, Name for	Tanzanian Sign Language	Tanzaniaanse Gebarentaal
udm, Name for	Udmurt	Udmurts
uga, Name for	Ugaritic	Ugaritisch
ugn, Name for	Ugandan Sign Language	Ugandese Gebarentaal
ugy, Name for	Uruguayan Sign Language	Urugayaanse Gebarentaal
uig, Name for	Uighur	Oeigoers, Oejgoers
ukl, Name for	Ukrainian Sign Language	Oekraïnse Gebarentaal
ukr, Name for	Ukrainian	Oekraïens
umb, Name for	Umbundu	Umbundu
und, Name for	Undetermined	Onbepaald
urd, Name for	Urdu	Urdu
uvh, Name for	Uri	Uri
uzb, Name for	Uzbek	Oezbeeks
vai, Name for	Vai	Vai
ven, Name for	Venda	Venda
vgt, Name for	Vlaamse Gebarentaal	Vlaamse Gebarentaal
vie, Name for	Vietnamese	Vietnamees
vol, Name for	Volapük	Volapük
vot, Name for	Votic	Votisch
vsi, Name for	Moldova Sign Language	Moldavische Gebarentaal
vsl, Name for	Venezuelan Sign Language	Venezuelaanse Gebarentaal
vsv, Name for	Valencian Sign Language	Valenciaanse Gebarentaal
waq, Name for	Wageman	Wageman
was, Name for	Washo	Wasjo
wes, Inverted name for	Pidgin, Cameroon	Pidgin, Kameroens
wes, Name for	Cameroon Pidgin	Kameroens Pidgin
wln, Name for	Walloon	Waals
wly, Name for	Waling	Waling
wmm, Name for	Maiwa (Indonesia)	Maiwa (Indonesië)
wol, Name for	Wolof	Wolof
xbb, Inverted name for	Burdekin, Lower	Burdekin, Laag
xbm, Inverted name for	Breton, Middle	Bretons, Middel
xbm, Name for	Middle Breton	Middelbretons
xcr, Name for	Carian	Carisch
xho, Name for	Xhosa	Xhosa
xil, Name for	Illyrian	Illyrisch
xki, Name for	Kenyan Sign Language	Keniaanse Gebarentaal
xkv, Name for	Kgalagadi	Kgalagadi
xlc, Name for	Lycian	Lycisch
xld, Name for	Lydian	Lydisch
xlu, Inverted name for	Luwian, Cuneiform	Luwisch, Spijkerschrift
xlu, Name for	Cuneiform Luwian	Spijkerschrift Luwisch
xms, Name for	Moroccan Sign Language	Marokaanse Gebarentaal
xna, Inverted name for	North Arabian, Ancient	Noord-Arabisch, Oud
xna, Name for	Ancient North Arabian	Oudnoord-Arabisch
xxb, Name for	Boro (Ghana)	Boro (Ghana)
xzp, Inverted name for	Zapotec, Ancient	Zapotec, Oud
xzp, Name for	Ancient Zapotec	Oudzapotec
yao, Name for	Yao	Yao
yap, Name for	Yapese	Yapees
yba, Name for	Yala	Yala
yid, Name for	Yiddish	Jiddisch
ymh, Name for	Mili	Mili
yor, Name for	Yoruba	Yoruba
yuc, Name for	Yuchi	Yuchi
zap, Name for	Zapotec	Zapotec
zay, Name for	Zayse-Zergulla	Zayse-Zergulla
zaz, Name for	Zari	Zari
zbl, Name for	Blissymbols	Blissymbolen
zen, Name for	Zenaga	Zenaga
zgh, Name for	Standard Moroccan Tamazight	Standaard Marokkaans Tamazight
zho, Name for	Chinese	Chinees
zib, Name for	Zimbabwe Sign Language	Zimbabwaanse Gebarentaal
zmv, Name for	Mbariman-Gudhinma	Mbariman-Gudhinma
zmw, Name for	Mbo (Democratic Republic of Congo)	Mbo (Democratische Republiek Congo)
zmz, Name for	Mbandja	Mbandja
zna, Name for	Zan Gula	Zan Gula
zne, Name for	Zande (individual language)	Zande (individuele taal)
zng, Name for	Mang	Mang
znk, Name for	Manangkari	Manangkari
zns, Name for	Mangas	Mangas
zoc, Inverted name for	Zoque, Copainalá	Zoque, Copainalá
zoc, Name for	Copainalá Zoque	Copainalá Zoque
zoh, Inverted name for	Zoque, Chimalapa	Zoque, Chimalapa
zom, Name for	Zou	Zou
zoo, Inverted name for	Zapotec, Asunción Mixtepec	Zapotec, Asunción Mixtepec
zoq, Inverted name for	Zoque, Tabasco	Zoque, Tabasco
zor, Inverted name for	Zoque, Rayón	Zoque, Rayón
zos, Inverted name for	Zoque, Francisco León	Zoque, Francisco León
zos, Name for	Francisco León Zoque	Francisco León Zoque
zpa, Inverted name for	Zapotec, Lachiguiri	Zapotec, Lachiguiri
zpb, Inverted name for	Zapotec, Yautepec	Zapotec, Yautepec
zpc, Inverted name for	Zapotec, Choapan	Zapotec, Choapan
zpe, Inverted name for	Zapotec, Petapa	Zapotec, Petapa
zpf, Inverted name for	Zapotec, San Pedro Quiatoni	Zapotec, San Pedro Quiatoni
zpf, Name for	San Pedro Quiatoni Zapotec	San Pedro Quiatoni Zapotec
zpg, Inverted name for	Zapotec, Guevea De Humboldt	Zapotec, Guevea De Humboldt
zpg, Name for	Guevea De Humboldt Zapotec	Guevea De Humboldt Zapotec
zph, Inverted name for	Zapotec, Totomachapan	Zapotec, Totomachapan
zpi, Inverted name for	Zapotec, Santa María Quiegolani	Zapotec, Santa María Quiegolani
zpi, Name for	Santa María Quiegolani Zapotec	Santa María Quiegolani Zapotec
zpj, Inverted name for	Zapotec, Quiavicuzas	Zapotec, Quiavicuzas
zpk, Inverted name for	Zapotec, Tlacolulita	Zapotec, Tlacolulita
zpl, Inverted name for	Zapotec, Lachixío	Zapotec, Lachixío
zpm, Inverted name for	Zapotec, Mixtepec	Zapotec, Mixtepec
zpn, Inverted name for	Zapotec, Santa Inés Yatzechi	Zapotec, Santa Inés Yatzechi
zpn, Name for	Santa Inés Yatzechi Zapotec	Santa Inés Yatzechi Zapotec
zpo, Inverted name for	Zapotec, Amatlán	Zapotec, Amatlán
zpp, Inverted name for	Zapotec, El Alto	Zapotec, El Alto
zpq, Inverted name for	Zapotec, Zoogocho	Zapotec, Zoogocho
zpr, Inverted name for	Zapotec, Santiago Xanica	Zapotec, Santiago Xanica
zpr, Name for	Santiago Xanica Zapotec	Santiago Xanica Zapotec
zps, Inverted name for	Zapotec, Coatlán	Zapotec, Coatlán
zpt, Inverted name for	Zapotec, San Vicente Coatlán	Zapotec, San Vicente Coatlán
zpt, Name for	San Vicente Coatlán Zapotec	San Vicente Coatlán Zapotec
zpu, Inverted name for	Zapotec, Yalálag	Zapotec, Yalálag
zpv, Inverted name for	Zapotec, Chichicapan	Zapotec, Chichicapan
zpw, Inverted name for	Zapotec, Zaniza	Zapotec, Zaniza
zpx, Inverted name for	Zapotec, San Baltazar Loxicha	Zapotec, San Baltazar Loxicha
zpx, Name for	San Baltazar Loxicha Zapotec	San Baltazar Loxicha Zapotec
zpy, Inverted name for	Zapotec, Mazaltepec	Zapotec, Mazaltepec
zpz, Inverted name for	Zapotec, Texmelucan	Zapotec, Texmelucan
zqe, Inverted name for	Zhuang, Qiubei	Tsjoeang, Qiubei
zra, Name for	Kara (Korea)	Kara (Korea)
zrg, Name for	Mirgan	Mirgan
zrn, Name for	Zerenkel	Zerenkel
zro, Name for	Záparo	Záparo
zrp, Name for	Zarphatic	Zarfatisch
zrs, Name for	Mairasi	Mairasi
zsa, Name for	Sarasira	Sarasira
zsk, Name for	Kaskean	Kaskean
zsl, Name for	Zambian Sign Language	Zambiaanse Gebarentaal
zsm, Inverted name for	Malay, Standard	Maleis, standaard
zsu, Name for	Sukurum	Sukurum
zte, Inverted name for	Zapotec, Elotepec	Zapotec, Elotepec
ztg, Inverted name for	Zapotec, Xanaguía	Zapotec, Xanaguía
ztl, Inverted name for	Zapotec, Lapaguía-Guivini	Zapotec, Lapaguía-Guivini
ztl, Name for	Lapaguía-Guivini Zapotec	Lapaguía-Guivini, Zapotec
ztm, Inverted name for	Zapotec, San Agustín Mixtepec	Zapotec, San Agustín Mixtepec
ztm, Name for	San Agustín Mixtepec Zapotec	San Agustín Mixtepec Zapotec
ztn, Inverted name for	Zapotec, Santa Catarina Albarradas	Zapotec, Santa Catarina Albarradas
ztn, Name for	Santa Catarina Albarradas Zapotec	Santa Catarina Albarradas Zapotec
ztp, Inverted name for	Zapotec, Loxicha	Zapotec, Loxicha
ztp, Name for	Loxicha Zapotec	Loxicha Zapotec
ztq, Inverted name for	Zapotec, Quioquitani-Quierí	Zapotec, Quioquitani-Quierí
ztq, Name for	Quioquitani-Quierí Zapotec	Quioquitani-Quierí Zapotec
zts, Inverted name for	Zapotec, Tilquiapan	Zapotec, Tilquiapan
ztt, Inverted name for	Zapotec, Tejalapan	Zapotec, Tejalapan
ztu, Inverted name for	Zapotec, Güilá	Zapotec, Güilá
ztu, Name for	Güilá Zapotec	Güilá Zapotec
ztx, Inverted name for	Zapotec, Zaachila	Zapotec, Zaachila
ztx, Name for	Zaachila Zapotec	Zaachila Zapotec
zty, Inverted name for	Zapotec, Yatee	Zapotec, Yatee
zty, Name for	Yatee Zapotec	Yatee Zapotec
zua, Name for	Zeem	Zeem
zuh, Name for	Tokano	Tokano
zul, Name for	Zulu	Zoeloe
zum, Name for	Kumzari	Kumzari
zun, Name for	Zuni	Zuni
zuy, Name for	Zumaya	Zumaya
zwa, Name for	Zay	Zay
zxx, Name for	No linguistic content	Geen linguïstische inhoud
zyb, Inverted name for	Zhuang, Yongbei	Tsjoeang, Yongbei
zyb, Name for	Yongbei Zhuang	Yongbei Tsjoeang
zyg, Inverted name for	Zhuang, Yang	Tsjoeang, Yang
zyg, Name for	Yang Zhuang	Yang Tsjoeang
zyj, Inverted name for	Zhuang, Youjiang	Tsjoeang, Youjiang
zyj, Name for	Youjiang Zhuang	Youjiang Tsjoeang
zyn, Inverted name for	Zhuang, Yongnan	Tsjoeang, Yongnan
zyn, Name for	Yongnan Zhuang	Yongnan Tsjoeang
zza, Name for	Zaza	Zaza
zzj, Inverted name for	Zhuang, Zuojiang	Tsjoeang, Zhoeang
zzj, Name for	Zuojiang Zhuang	Zhoeang Tsjoeang
aaa, Name for	Zhuang, Zuojiang	
aab, Name for	Zhuang, Zuojiang	
aac, Name for	Zhuang, Zuojiang	
aad, Name for	Zhuang, Zuojiang	
aae, Inverted name for	Zhuang, Zuojiang	
aae, Name for	Zhuang, Zuojiang	
aaf, Name for	Zhuang, Zuojiang	
aag, Name for	Zhuang, Zuojiang	
aah, Inverted name for	Zhuang, Zuojiang	
aah, Name for	Zhuang, Zuojiang	
aai, Name for	Zhuang, Zuojiang	
aak, Name for	Zhuang, Zuojiang	
aal, Name for	Zhuang, Zuojiang	
aan, Name for	Zhuang, Zuojiang	
aao, Inverted name for	Zhuang, Zuojiang	
aao, Name for	Zhuang, Zuojiang	
aap, Inverted name for	Zhuang, Zuojiang	
aap, Name for	Zhuang, Zuojiang	
aaq, Inverted name for	Zhuang, Zuojiang	
aaq, Name for	Zhuang, Zuojiang	
aar, Name for	Zhuang, Zuojiang	
aas, Name for	Zhuang, Zuojiang	
aat, Inverted name for	Zhuang, Zuojiang	
aat, Name for	Zhuang, Zuojiang	
aau, Name for	Zhuang, Zuojiang	
aaw, Name for	Zhuang, Zuojiang	
aax, Name for	Zhuang, Zuojiang	
aaz, Name for	Zhuang, Zuojiang	
aba, Name for	Zhuang, Zuojiang	
abb, Name for	Zhuang, Zuojiang	
abc, Inverted name for	Zhuang, Zuojiang	
abc, Name for	Zhuang, Zuojiang	
abd, Name for	Zhuang, Zuojiang	
abe, Inverted name for	Zhuang, Zuojiang	
abe, Name for	Zhuang, Zuojiang	
abf, Name for	Zhuang, Zuojiang	
abg, Name for	Zhuang, Zuojiang	
abh, Inverted name for	Zhuang, Zuojiang	
abh, Name for	Zhuang, Zuojiang	
abi, Name for	Zhuang, Zuojiang	
abj, Name for	Zhuang, Zuojiang	
abk, Name for	Zhuang, Zuojiang	
abl, Name for	Zhuang, Zuojiang	
abm, Name for	Zhuang, Zuojiang	
abn, Name for	Zhuang, Zuojiang	
abo, Name for	Zhuang, Zuojiang	
abp, Inverted name for	Zhuang, Zuojiang	
abp, Name for	Zhuang, Zuojiang	
abq, Name for	Zhuang, Zuojiang	
abr, Name for	Zhuang, Zuojiang	
abs, Inverted name for	Zhuang, Zuojiang	
abs, Name for	Zhuang, Zuojiang	
abt, Name for	Zhuang, Zuojiang	
abu, Name for	Zhuang, Zuojiang	
abv, Inverted name for	Zhuang, Zuojiang	
abv, Name for	Zhuang, Zuojiang	
abw, Name for	Zhuang, Zuojiang	
abx, Name for	Zhuang, Zuojiang	
aby, Name for	Zhuang, Zuojiang	
abz, Name for	Zhuang, Zuojiang	
aca, Name for	Zhuang, Zuojiang	
acb, Name for	Zhuang, Zuojiang	
acd, Name for	Zhuang, Zuojiang	
ace, Name for	Zhuang, Zuojiang	
acf, Inverted name for	Zhuang, Zuojiang	
acf, Name for	Zhuang, Zuojiang	
ach, Name for	Zhuang, Zuojiang	
aci, Name for	Zhuang, Zuojiang	
ack, Name for	Zhuang, Zuojiang	
acl, Name for	Zhuang, Zuojiang	
acm, Inverted name for	Zhuang, Zuojiang	
acm, Name for	Zhuang, Zuojiang	
acn, Name for	Zhuang, Zuojiang	
acp, Inverted name for	Zhuang, Zuojiang	
acp, Name for	Zhuang, Zuojiang	
acq, Inverted name for	Zhuang, Zuojiang	
acq, Name for	Zhuang, Zuojiang	
acr, Name for	Zhuang, Zuojiang	
acs, Name for	Zhuang, Zuojiang	
act, Name for	Zhuang, Zuojiang	
acu, Name for	Zhuang, Zuojiang	
acv, Name for	Zhuang, Zuojiang	
acw, Inverted name for	Zhuang, Zuojiang	
acw, Name for	Zhuang, Zuojiang	
acx, Inverted name for	Zhuang, Zuojiang	
acx, Name for	Zhuang, Zuojiang	
acy, Inverted name for	Zhuang, Zuojiang	
acy, Name for	Zhuang, Zuojiang	
acz, Name for	Zhuang, Zuojiang	
ada, Name for	Zhuang, Zuojiang	
adb, Name for	Zhuang, Zuojiang	
add, Name for	Zhuang, Zuojiang	
ade, Name for	Zhuang, Zuojiang	
adf, Inverted name for	Zhuang, Zuojiang	
adf, Name for	Zhuang, Zuojiang	
adg, Name for	Zhuang, Zuojiang	
adh, Name for	Zhuang, Zuojiang	
adi, Name for	Zhuang, Zuojiang	
adj, Name for	Zhuang, Zuojiang	
adl, Name for	Zhuang, Zuojiang	
adn, Name for	Zhuang, Zuojiang	
ado, Name for	Zhuang, Zuojiang	
adq, Name for	Zhuang, Zuojiang	
adr, Name for	Zhuang, Zuojiang	
adt, Name for	Zhuang, Zuojiang	
adu, Name for	Zhuang, Zuojiang	
adw, Name for	Zhuang, Zuojiang	
adx, Inverted name for	Zhuang, Zuojiang	
adx, Name for	Zhuang, Zuojiang	
ady, Name for	Zhuang, Zuojiang	
adz, Name for	Zhuang, Zuojiang	
aea, Name for	Zhuang, Zuojiang	
aeb, Inverted name for	Zhuang, Zuojiang	
aeb, Name for	Zhuang, Zuojiang	
aec, Inverted name for	Zhuang, Zuojiang	
aec, Name for	Zhuang, Zuojiang	
aed, Name for	Zhuang, Zuojiang	
aee, Inverted name for	Zhuang, Zuojiang	
aee, Name for	Zhuang, Zuojiang	
aek, Name for	Zhuang, Zuojiang	
ael, Name for	Zhuang, Zuojiang	
aem, Name for	Zhuang, Zuojiang	
aen, Name for	Zhuang, Zuojiang	
aeq, Name for	Zhuang, Zuojiang	
aer, Inverted name for	Zhuang, Zuojiang	
aer, Name for	Zhuang, Zuojiang	
aes, Name for	Zhuang, Zuojiang	
aeu, Name for	Zhuang, Zuojiang	
aew, Name for	Zhuang, Zuojiang	
aey, Name for	Zhuang, Zuojiang	
aez, Name for	Zhuang, Zuojiang	
afb, Inverted name for	Zhuang, Zuojiang	
afb, Name for	Zhuang, Zuojiang	
afd, Name for	Zhuang, Zuojiang	
afe, Name for	Zhuang, Zuojiang	
afg, Name for	Zhuang, Zuojiang	
afh, Name for	Zhuang, Zuojiang	
afi, Name for	Zhuang, Zuojiang	
afk, Name for	Zhuang, Zuojiang	
afn, Name for	Zhuang, Zuojiang	
afo, Name for	Zhuang, Zuojiang	
afp, Name for	Zhuang, Zuojiang	
afr, Name for	Zhuang, Zuojiang	
aft, Name for	Zhuang, Zuojiang	
afu, Name for	Zhuang, Zuojiang	
afz, Name for	Zhuang, Zuojiang	
aga, Name for	Zhuang, Zuojiang	
agb, Name for	Zhuang, Zuojiang	
agc, Name for	Zhuang, Zuojiang	
agd, Name for	Zhuang, Zuojiang	
age, Name for	Zhuang, Zuojiang	
agf, Name for	Zhuang, Zuojiang	
agg, Name for	Zhuang, Zuojiang	
agh, Name for	Zhuang, Zuojiang	
agi, Name for	Zhuang, Zuojiang	
agj, Name for	Zhuang, Zuojiang	
agl, Name for	Zhuang, Zuojiang	
agm, Name for	Zhuang, Zuojiang	
ago, Name for	Zhuang, Zuojiang	
agq, Name for	Zhuang, Zuojiang	
ags, Name for	Zhuang, Zuojiang	
agu, Name for	Zhuang, Zuojiang	
agw, Name for	Zhuang, Zuojiang	
agx, Name for	Zhuang, Zuojiang	
agy, Inverted name for	Zhuang, Zuojiang	
agy, Name for	Zhuang, Zuojiang	
agz, Inverted name for	Zhuang, Zuojiang	
agz, Name for	Zhuang, Zuojiang	
aha, Name for	Zhuang, Zuojiang	
ahb, Name for	Zhuang, Zuojiang	
ahh, Name for	Zhuang, Zuojiang	
ahk, Name for	Zhuang, Zuojiang	
ahl, Name for	Zhuang, Zuojiang	
ahr, Name for	Zhuang, Zuojiang	
aht, Name for	Zhuang, Zuojiang	
aia, Name for	Zhuang, Zuojiang	
aib, Name for	Zhuang, Zuojiang	
aic, Name for	Zhuang, Zuojiang	
aid, Name for	Zhuang, Zuojiang	
aie, Name for	Zhuang, Zuojiang	
aif, Name for	Zhuang, Zuojiang	
aig, Name for	Zhuang, Zuojiang	
aij, Name for	Zhuang, Zuojiang	
aik, Name for	Zhuang, Zuojiang	
ail, Name for	Zhuang, Zuojiang	
aim, Name for	Zhuang, Zuojiang	
ain, Name for	Zhuang, Zuojiang	
aio, Name for	Zhuang, Zuojiang	
aip, Name for	Zhuang, Zuojiang	
aiq, Name for	Zhuang, Zuojiang	
air, Name for	Zhuang, Zuojiang	
ais, Inverted name for	Zhuang, Zuojiang	
ais, Name for	Zhuang, Zuojiang	
aiw, Name for	Zhuang, Zuojiang	
aix, Name for	Zhuang, Zuojiang	
aiy, Name for	Zhuang, Zuojiang	
ajn, Name for	Zhuang, Zuojiang	
ajp, Inverted name for	Zhuang, Zuojiang	
ajp, Name for	Zhuang, Zuojiang	
ajt, Inverted name for	Zhuang, Zuojiang	
ajt, Name for	Zhuang, Zuojiang	
aju, Inverted name for	Zhuang, Zuojiang	
aju, Name for	Zhuang, Zuojiang	
ajw, Name for	Zhuang, Zuojiang	
ajz, Inverted name for	Zhuang, Zuojiang	
ajz, Name for	Zhuang, Zuojiang	
aka, Name for	Zhuang, Zuojiang	
akb, Name for	Zhuang, Zuojiang	
ake, Name for	Zhuang, Zuojiang	
akf, Name for	Zhuang, Zuojiang	
akg, Name for	Zhuang, Zuojiang	
aki, Name for	Zhuang, Zuojiang	
akk, Name for	Zhuang, Zuojiang	
akl, Name for	Zhuang, Zuojiang	
akm, Name for	Zhuang, Zuojiang	
akq, Name for	Zhuang, Zuojiang	
akr, Name for	Zhuang, Zuojiang	
aku, Name for	Zhuang, Zuojiang	
akw, Name for	Zhuang, Zuojiang	
akz, Name for	Zhuang, Zuojiang	
ala, Name for	Zhuang, Zuojiang	
alc, Name for	Zhuang, Zuojiang	
ald, Name for	Zhuang, Zuojiang	
ale, Name for	Zhuang, Zuojiang	
alh, Name for	Zhuang, Zuojiang	
ali, Name for	Zhuang, Zuojiang	
alj, Name for	Zhuang, Zuojiang	
alk, Name for	Zhuang, Zuojiang	
all, Name for	Zhuang, Zuojiang	
alm, Name for	Zhuang, Zuojiang	
aln, Inverted name for	Zhuang, Zuojiang	
aln, Name for	Zhuang, Zuojiang	
alq, Name for	Zhuang, Zuojiang	
als, Inverted name for	Zhuang, Zuojiang	
als, Name for	Zhuang, Zuojiang	
alt, Inverted name for	Zhuang, Zuojiang	
alt, Name for	Zhuang, Zuojiang	
alx, Name for	Zhuang, Zuojiang	
aly, Name for	Zhuang, Zuojiang	
amc, Name for	Zhuang, Zuojiang	
amf, Name for	Zhuang, Zuojiang	
amh, Name for	Zhuang, Zuojiang	
amj, Name for	Zhuang, Zuojiang	
amk, Name for	Zhuang, Zuojiang	
aml, Name for	Zhuang, Zuojiang	
amn, Name for	Zhuang, Zuojiang	
amp, Name for	Zhuang, Zuojiang	
amq, Name for	Zhuang, Zuojiang	
amr, Name for	Zhuang, Zuojiang	
ams, Inverted name for	Zhuang, Zuojiang	
ams, Name for	Zhuang, Zuojiang	
amy, Name for	Zhuang, Zuojiang	
amz, Name for	Zhuang, Zuojiang	
anb, Name for	Zhuang, Zuojiang	
anc, Name for	Zhuang, Zuojiang	
ang, Inverted name for	Zhuang, Zuojiang	
ang, Name for	Zhuang, Zuojiang	
anh, Name for	Zhuang, Zuojiang	
ani, Name for	Zhuang, Zuojiang	
ank, Name for	Zhuang, Zuojiang	
anl, Inverted name for	Zhuang, Zuojiang	
ann, Name for	Zhuang, Zuojiang	
anp, Name for	Zhuang, Zuojiang	
anq, Name for	Zhuang, Zuojiang	
anr, Name for	Zhuang, Zuojiang	
ans, Name for	Zhuang, Zuojiang	
anv, Name for	Zhuang, Zuojiang	
anw, Name for	Zhuang, Zuojiang	
any, Name for	Zhuang, Zuojiang	
aoa, Name for	Zhuang, Zuojiang	
aoc, Name for	Zhuang, Zuojiang	
aod, Name for	Zhuang, Zuojiang	
aof, Name for	Zhuang, Zuojiang	
aoh, Name for	Zhuang, Zuojiang	
aoj, Name for	Zhuang, Zuojiang	
aor, Name for	Zhuang, Zuojiang	
aos, Name for	Zhuang, Zuojiang	
aot, Name for	Zhuang, Zuojiang	
aox, Name for	Zhuang, Zuojiang	
apb, Name for	Zhuang, Zuojiang	
apc, Inverted name for	Zhuang, Zuojiang	
apc, Name for	Zhuang, Zuojiang	
apd, Inverted name for	Zhuang, Zuojiang	
apd, Name for	Zhuang, Zuojiang	
apf, Name for	Zhuang, Zuojiang	
apg, Name for	Zhuang, Zuojiang	
aph, Name for	Zhuang, Zuojiang	
api, Name for	Zhuang, Zuojiang	
apo, Name for	Zhuang, Zuojiang	
app, Name for	Zhuang, Zuojiang	
apv, Name for	Zhuang, Zuojiang	
apx, Name for	Zhuang, Zuojiang	
aqc, Name for	Zhuang, Zuojiang	
aqg, Name for	Zhuang, Zuojiang	
aqn, Inverted name for	Zhuang, Zuojiang	
aqn, Name for	Zhuang, Zuojiang	
aqt, Name for	Zhuang, Zuojiang	
aqz, Name for	Zhuang, Zuojiang	
ara, Name for	Zhuang, Zuojiang	
arb, Inverted name for	Zhuang, Zuojiang	
arb, Name for	Zhuang, Zuojiang	
arc, Inverted name for	Zhuang, Zuojiang	
arc, Name for	Zhuang, Zuojiang	
ard, Name for	Zhuang, Zuojiang	
arg, Name for	Zhuang, Zuojiang	
arh, Name for	Zhuang, Zuojiang	
ari, Name for	Zhuang, Zuojiang	
arj, Name for	Zhuang, Zuojiang	
arl, Name for	Zhuang, Zuojiang	
arn, Name for	Zhuang, Zuojiang	
aro, Name for	Zhuang, Zuojiang	
arp, Name for	Zhuang, Zuojiang	
arq, Inverted name for	Zhuang, Zuojiang	
arq, Name for	Zhuang, Zuojiang	
ars, Inverted name for	Zhuang, Zuojiang	
ars, Name for	Zhuang, Zuojiang	
arw, Name for	Zhuang, Zuojiang	
ary, Inverted name for	Zhuang, Zuojiang	
ary, Name for	Zhuang, Zuojiang	
arz, Inverted name for	Zhuang, Zuojiang	
arz, Name for	Zhuang, Zuojiang	
asa, Name for	Zhuang, Zuojiang	
asd, Name for	Zhuang, Zuojiang	
ase, Name for	Zhuang, Zuojiang	
asf, Name for	Zhuang, Zuojiang	
asi, Name for	Zhuang, Zuojiang	
asj, Name for	Zhuang, Zuojiang	
ask, Name for	Zhuang, Zuojiang	
asm, Name for	Zhuang, Zuojiang	
aso, Name for	Zhuang, Zuojiang	
asp, Name for	Zhuang, Zuojiang	
asq, Name for	Zhuang, Zuojiang	
ass, Name for	Zhuang, Zuojiang	
ast, Name for	Zhuang, Zuojiang	
asv, Name for	Zhuang, Zuojiang	
asw, Name for	Zhuang, Zuojiang	
atb, Name for	Zhuang, Zuojiang	
atm, Name for	Zhuang, Zuojiang	
atn, Name for	Zhuang, Zuojiang	
ato, Name for	Zhuang, Zuojiang	
atv, Inverted name for	Zhuang, Zuojiang	
atv, Name for	Zhuang, Zuojiang	
atx, Name for	Zhuang, Zuojiang	
aty, Name for	Zhuang, Zuojiang	
atz, Name for	Zhuang, Zuojiang	
aub, Name for	Zhuang, Zuojiang	
auc, Name for	Zhuang, Zuojiang	
aug, Name for	Zhuang, Zuojiang	
auh, Name for	Zhuang, Zuojiang	
auj, Name for	Zhuang, Zuojiang	
auk, Name for	Zhuang, Zuojiang	
aul, Name for	Zhuang, Zuojiang	
aup, Name for	Zhuang, Zuojiang	
auq, Name for	Zhuang, Zuojiang	
aur, Name for	Zhuang, Zuojiang	
auw, Name for	Zhuang, Zuojiang	
auy, Name for	Zhuang, Zuojiang	
auz, Inverted name for	Zhuang, Zuojiang	
auz, Name for	Zhuang, Zuojiang	
ava, Name for	Zhuang, Zuojiang	
avb, Name for	Zhuang, Zuojiang	
ave, Name for	Zhuang, Zuojiang	
avi, Name for	Zhuang, Zuojiang	
avk, Name for	Zhuang, Zuojiang	
avn, Name for	Zhuang, Zuojiang	
avs, Name for	Zhuang, Zuojiang	
avu, Name for	Zhuang, Zuojiang	
awa, Name for	Zhuang, Zuojiang	
awh, Name for	Zhuang, Zuojiang	
awm, Name for	Zhuang, Zuojiang	
awo, Name for	Zhuang, Zuojiang	
awx, Name for	Zhuang, Zuojiang	
axe, Name for	Zhuang, Zuojiang	
axl, Inverted name for	Zhuang, Zuojiang	
axl, Name for	Zhuang, Zuojiang	
axm, Inverted name for	Zhuang, Zuojiang	
axm, Name for	Zhuang, Zuojiang	
aya, Name for	Zhuang, Zuojiang	
ayc, Inverted name for	Zhuang, Zuojiang	
ayc, Name for	Zhuang, Zuojiang	
aye, Name for	Zhuang, Zuojiang	
ayg, Name for	Zhuang, Zuojiang	
ayh, Inverted name for	Zhuang, Zuojiang	
ayh, Name for	Zhuang, Zuojiang	
ayi, Name for	Zhuang, Zuojiang	
ayl, Inverted name for	Zhuang, Zuojiang	
ayl, Name for	Zhuang, Zuojiang	
aym, Name for	Zhuang, Zuojiang	
ayn, Inverted name for	Zhuang, Zuojiang	
ayn, Name for	Zhuang, Zuojiang	
ayo, Name for	Zhuang, Zuojiang	
ayp, Inverted name for	Zhuang, Zuojiang	
ayp, Name for	Zhuang, Zuojiang	
ayr, Inverted name for	Zhuang, Zuojiang	
ayr, Name for	Zhuang, Zuojiang	
ays, Inverted name for	Zhuang, Zuojiang	
ays, Name for	Zhuang, Zuojiang	
ayu, Name for	Zhuang, Zuojiang	
ayz, Name for	Zhuang, Zuojiang	
aza, Name for	Zhuang, Zuojiang	
azb, Inverted name for	Zhuang, Zuojiang	
azb, Name for	Zhuang, Zuojiang	
azd, Inverted name for	Zhuang, Zuojiang	
azd, Name for	Zhuang, Zuojiang	
aze, Name for	Zhuang, Zuojiang	
azj, Inverted name for	Zhuang, Zuojiang	
azj, Name for	Zhuang, Zuojiang	
azn, Inverted name for	Zhuang, Zuojiang	
azn, Name for	Zhuang, Zuojiang	
azo, Name for	Zhuang, Zuojiang	
baa, Name for	Zhuang, Zuojiang	
bac, Name for	Zhuang, Zuojiang	
bag, Name for	Zhuang, Zuojiang	
baj, Name for	Zhuang, Zuojiang	
bak, Name for	Zhuang, Zuojiang	
bal, Name for	Zhuang, Zuojiang	
bam, Name for	Zhuang, Zuojiang	
ban, Name for	Zhuang, Zuojiang	
bao, Name for	Zhuang, Zuojiang	
bap, Name for	Zhuang, Zuojiang	
bar, Name for	Zhuang, Zuojiang	
bas, Name for	Zhuang, Zuojiang	
bau, Name for	Zhuang, Zuojiang	
bav, Name for	Zhuang, Zuojiang	
baw, Name for	Zhuang, Zuojiang	
bax, Name for	Zhuang, Zuojiang	
bay, Name for	Zhuang, Zuojiang	
bbb, Name for	Zhuang, Zuojiang	
bbd, Name for	Zhuang, Zuojiang	
bbe, Name for	Zhuang, Zuojiang	
bbf, Name for	Zhuang, Zuojiang	
bbg, Name for	Zhuang, Zuojiang	
bbh, Name for	Zhuang, Zuojiang	
bbi, Name for	Zhuang, Zuojiang	
bbl, Name for	Zhuang, Zuojiang	
bbm, Name for	Zhuang, Zuojiang	
bbq, Name for	Zhuang, Zuojiang	
bbr, Name for	Zhuang, Zuojiang	
bbs, Name for	Zhuang, Zuojiang	
bbv, Name for	Zhuang, Zuojiang	
bbw, Name for	Zhuang, Zuojiang	
bbx, Name for	Zhuang, Zuojiang	
bby, Name for	Zhuang, Zuojiang	
bcc, Inverted name for	Zhuang, Zuojiang	
bcc, Name for	Zhuang, Zuojiang	
bcd, Inverted name for	Zhuang, Zuojiang	
bcd, Name for	Zhuang, Zuojiang	
bce, Name for	Zhuang, Zuojiang	
bcf, Name for	Zhuang, Zuojiang	
bcg, Name for	Zhuang, Zuojiang	
bch, Name for	Zhuang, Zuojiang	
bcj, Name for	Zhuang, Zuojiang	
bck, Name for	Zhuang, Zuojiang	
bcl, Inverted name for	Zhuang, Zuojiang	
bcn, Name for	Zhuang, Zuojiang	
bco, Name for	Zhuang, Zuojiang	
bcq, Name for	Zhuang, Zuojiang	
bcr, Name for	Zhuang, Zuojiang	
bcs, Name for	Zhuang, Zuojiang	
bct, Name for	Zhuang, Zuojiang	
bcu, Name for	Zhuang, Zuojiang	
bcw, Name for	Zhuang, Zuojiang	
bcy, Name for	Zhuang, Zuojiang	
bda, Name for	Zhuang, Zuojiang	
bdb, Name for	Zhuang, Zuojiang	
bdd, Name for	Zhuang, Zuojiang	
bde, Name for	Zhuang, Zuojiang	
bdf, Name for	Zhuang, Zuojiang	
bdg, Name for	Zhuang, Zuojiang	
bdh, Name for	Zhuang, Zuojiang	
bdi, Name for	Zhuang, Zuojiang	
bdj, Name for	Zhuang, Zuojiang	
bdk, Name for	Zhuang, Zuojiang	
bdl, Inverted name for	Zhuang, Zuojiang	
bdl, Name for	Zhuang, Zuojiang	
bdm, Name for	Zhuang, Zuojiang	
bdn, Name for	Zhuang, Zuojiang	
bdo, Name for	Zhuang, Zuojiang	
bdp, Name for	Zhuang, Zuojiang	
bdq, Name for	Zhuang, Zuojiang	
bdr, Inverted name for	Zhuang, Zuojiang	
bdr, Name for	Zhuang, Zuojiang	
bds, Name for	Zhuang, Zuojiang	
bdt, Name for	Zhuang, Zuojiang	
bdu, Name for	Zhuang, Zuojiang	
bdv, Name for	Zhuang, Zuojiang	
bdw, Name for	Zhuang, Zuojiang	
bdx, Name for	Zhuang, Zuojiang	
bdy, Name for	Zhuang, Zuojiang	
bdz, Name for	Zhuang, Zuojiang	
bea, Name for	Zhuang, Zuojiang	
beb, Name for	Zhuang, Zuojiang	
bec, Name for	Zhuang, Zuojiang	
bed, Name for	Zhuang, Zuojiang	
bee, Name for	Zhuang, Zuojiang	
bef, Name for	Zhuang, Zuojiang	
beg, Name for	Zhuang, Zuojiang	
beh, Name for	Zhuang, Zuojiang	
bei, Name for	Zhuang, Zuojiang	
bej, Name for	Zhuang, Zuojiang	
bek, Name for	Zhuang, Zuojiang	
bel, Name for	Zhuang, Zuojiang	
bem, Name for	Zhuang, Zuojiang	
ben, Common name for	Zhuang, Zuojiang	
ben, Name for	Zhuang, Zuojiang	
beo, Name for	Zhuang, Zuojiang	
bep, Name for	Zhuang, Zuojiang	
beq, Name for	Zhuang, Zuojiang	
bes, Name for	Zhuang, Zuojiang	
beu, Name for	Zhuang, Zuojiang	
bew, Name for	Zhuang, Zuojiang	
bez, Name for	Zhuang, Zuojiang	
bfa, Name for	Zhuang, Zuojiang	
bfc, Inverted name for	Zhuang, Zuojiang	
bfc, Name for	Zhuang, Zuojiang	
bfd, Name for	Zhuang, Zuojiang	
bfe, Name for	Zhuang, Zuojiang	
bfg, Name for	Zhuang, Zuojiang	
bfi, Name for	Zhuang, Zuojiang	
bfm, Name for	Zhuang, Zuojiang	
bfn, Name for	Zhuang, Zuojiang	
bfp, Name for	Zhuang, Zuojiang	
bfq, Name for	Zhuang, Zuojiang	
bfr, Name for	Zhuang, Zuojiang	
bfs, Inverted name for	Zhuang, Zuojiang	
bfs, Name for	Zhuang, Zuojiang	
bft, Name for	Zhuang, Zuojiang	
bfu, Name for	Zhuang, Zuojiang	
bfw, Name for	Zhuang, Zuojiang	
bfx, Name for	Zhuang, Zuojiang	
bfy, Name for	Zhuang, Zuojiang	
bfz, Name for	Zhuang, Zuojiang	
bgb, Name for	Zhuang, Zuojiang	
bgc, Name for	Zhuang, Zuojiang	
bgd, Name for	Zhuang, Zuojiang	
bge, Name for	Zhuang, Zuojiang	
bgf, Name for	Zhuang, Zuojiang	
bgg, Name for	Zhuang, Zuojiang	
bgi, Name for	Zhuang, Zuojiang	
bgj, Name for	Zhuang, Zuojiang	
bgk, Name for	Zhuang, Zuojiang	
bgn, Inverted name for	Zhuang, Zuojiang	
bgo, Name for	Zhuang, Zuojiang	
bgp, Inverted name for	Zhuang, Zuojiang	
bgq, Name for	Zhuang, Zuojiang	
bgr, Inverted name for	Zhuang, Zuojiang	
bgr, Name for	Zhuang, Zuojiang	
bgs, Name for	Zhuang, Zuojiang	
bgt, Name for	Zhuang, Zuojiang	
bgu, Name for	Zhuang, Zuojiang	
bgv, Name for	Zhuang, Zuojiang	
bgw, Name for	Zhuang, Zuojiang	
bgx, Inverted name for	Zhuang, Zuojiang	
bgx, Name for	Zhuang, Zuojiang	
bgy, Name for	Zhuang, Zuojiang	
bgz, Name for	Zhuang, Zuojiang	
bha, Name for	Zhuang, Zuojiang	
bhb, Name for	Zhuang, Zuojiang	
bhc, Name for	Zhuang, Zuojiang	
bhd, Name for	Zhuang, Zuojiang	
bhe, Name for	Zhuang, Zuojiang	
bhf, Name for	Zhuang, Zuojiang	
bhg, Name for	Zhuang, Zuojiang	
bhh, Name for	Zhuang, Zuojiang	
bhi, Name for	Zhuang, Zuojiang	
bhj, Name for	Zhuang, Zuojiang	
bhl, Name for	Zhuang, Zuojiang	
bhm, Name for	Zhuang, Zuojiang	
bho, Name for	Zhuang, Zuojiang	
bhp, Name for	Zhuang, Zuojiang	
bhs, Name for	Zhuang, Zuojiang	
bht, Name for	Zhuang, Zuojiang	
bhu, Name for	Zhuang, Zuojiang	
bhv, Name for	Zhuang, Zuojiang	
bhw, Name for	Zhuang, Zuojiang	
bhx, Name for	Zhuang, Zuojiang	
bhy, Name for	Zhuang, Zuojiang	
bhz, Name for	Zhuang, Zuojiang	
bia, Name for	Zhuang, Zuojiang	
bib, Name for	Zhuang, Zuojiang	
bic, Name for	Zhuang, Zuojiang	
bid, Name for	Zhuang, Zuojiang	
bie, Name for	Zhuang, Zuojiang	
bif, Name for	Zhuang, Zuojiang	
big, Name for	Zhuang, Zuojiang	
bik, Name for	Zhuang, Zuojiang	
bil, Name for	Zhuang, Zuojiang	
bim, Name for	Zhuang, Zuojiang	
bin, Name for	Zhuang, Zuojiang	
bio, Name for	Zhuang, Zuojiang	
bip, Name for	Zhuang, Zuojiang	
biq, Name for	Zhuang, Zuojiang	
bir, Name for	Zhuang, Zuojiang	
bis, Name for	Zhuang, Zuojiang	
bit, Name for	Zhuang, Zuojiang	
biu, Name for	Zhuang, Zuojiang	
biv, Inverted name for	Zhuang, Zuojiang	
biv, Name for	Zhuang, Zuojiang	
bix, Name for	Zhuang, Zuojiang	
biy, Name for	Zhuang, Zuojiang	
biz, Name for	Zhuang, Zuojiang	
bja, Name for	Zhuang, Zuojiang	
bjb, Name for	Zhuang, Zuojiang	
bjc, Name for	Zhuang, Zuojiang	
bje, Inverted name for	Zhuang, Zuojiang	
bje, Name for	Zhuang, Zuojiang	
bjh, Name for	Zhuang, Zuojiang	
bji, Name for	Zhuang, Zuojiang	
bjj, Name for	Zhuang, Zuojiang	
bjn, Name for	Zhuang, Zuojiang	
bjo, Name for	Zhuang, Zuojiang	
bjr, Name for	Zhuang, Zuojiang	
bjs, Name for	Zhuang, Zuojiang	
bju, Name for	Zhuang, Zuojiang	
bjv, Name for	Zhuang, Zuojiang	
bjy, Name for	Zhuang, Zuojiang	
bjz, Name for	Zhuang, Zuojiang	
bka, Name for	Zhuang, Zuojiang	
bkd, Name for	Zhuang, Zuojiang	
bkf, Name for	Zhuang, Zuojiang	
bkg, Name for	Zhuang, Zuojiang	
bki, Name for	Zhuang, Zuojiang	
bkj, Name for	Zhuang, Zuojiang	
bkl, Name for	Zhuang, Zuojiang	
bkn, Name for	Zhuang, Zuojiang	
bkq, Name for	Zhuang, Zuojiang	
bks, Inverted name for	Zhuang, Zuojiang	
bks, Name for	Zhuang, Zuojiang	
bku, Name for	Zhuang, Zuojiang	
bkw, Name for	Zhuang, Zuojiang	
bla, Name for	Zhuang, Zuojiang	
blb, Name for	Zhuang, Zuojiang	
bld, Name for	Zhuang, Zuojiang	
blf, Name for	Zhuang, Zuojiang	
blg, Name for	Zhuang, Zuojiang	
blh, Name for	Zhuang, Zuojiang	
bli, Name for	Zhuang, Zuojiang	
blj, Name for	Zhuang, Zuojiang	
blk, Inverted name for	Zhuang, Zuojiang	
bll, Name for	Zhuang, Zuojiang	
bln, Inverted name for	Zhuang, Zuojiang	
blp, Name for	Zhuang, Zuojiang	
blr, Name for	Zhuang, Zuojiang	
bls, Name for	Zhuang, Zuojiang	
blv, Name for	Zhuang, Zuojiang	
blw, Name for	Zhuang, Zuojiang	
bly, Name for	Zhuang, Zuojiang	
blz, Name for	Zhuang, Zuojiang	
bma, Name for	Zhuang, Zuojiang	
bmb, Name for	Zhuang, Zuojiang	
bmc, Name for	Zhuang, Zuojiang	
bmd, Inverted name for	Zhuang, Zuojiang	
bmd, Name for	Zhuang, Zuojiang	
bmg, Name for	Zhuang, Zuojiang	
bmh, Name for	Zhuang, Zuojiang	
bmi, Name for	Zhuang, Zuojiang	
bmk, Name for	Zhuang, Zuojiang	
bml, Name for	Zhuang, Zuojiang	
bmo, Name for	Zhuang, Zuojiang	
bmp, Name for	Zhuang, Zuojiang	
bmr, Name for	Zhuang, Zuojiang	
bms, Inverted name for	Zhuang, Zuojiang	
bms, Name for	Zhuang, Zuojiang	
bmv, Name for	Zhuang, Zuojiang	
bmw, Name for	Zhuang, Zuojiang	
bmx, Name for	Zhuang, Zuojiang	
bmz, Name for	Zhuang, Zuojiang	
bnb, Name for	Zhuang, Zuojiang	
bnc, Name for	Zhuang, Zuojiang	
bnd, Name for	Zhuang, Zuojiang	
bne, Name for	Zhuang, Zuojiang	
bnf, Name for	Zhuang, Zuojiang	
bng, Name for	Zhuang, Zuojiang	
bni, Name for	Zhuang, Zuojiang	
bnl, Name for	Zhuang, Zuojiang	
bnm, Name for	Zhuang, Zuojiang	
bnp, Name for	Zhuang, Zuojiang	
bnq, Name for	Zhuang, Zuojiang	
bns, Name for	Zhuang, Zuojiang	
bnu, Name for	Zhuang, Zuojiang	
bnw, Name for	Zhuang, Zuojiang	
bnz, Name for	Zhuang, Zuojiang	
boa, Name for	Zhuang, Zuojiang	
bob, Name for	Zhuang, Zuojiang	
bod, Name for	Zhuang, Zuojiang	
boe, Name for	Zhuang, Zuojiang	
bof, Name for	Zhuang, Zuojiang	
boh, Name for	Zhuang, Zuojiang	
bok, Name for	Zhuang, Zuojiang	
bol, Name for	Zhuang, Zuojiang	
bom, Name for	Zhuang, Zuojiang	
bon, Name for	Zhuang, Zuojiang	
bop, Name for	Zhuang, Zuojiang	
boq, Name for	Zhuang, Zuojiang	
bor, Name for	Zhuang, Zuojiang	
bos, Name for	Zhuang, Zuojiang	
bot, Name for	Zhuang, Zuojiang	
bou, Name for	Zhuang, Zuojiang	
bov, Name for	Zhuang, Zuojiang	
bow, Name for	Zhuang, Zuojiang	
box, Name for	Zhuang, Zuojiang	
boy, Name for	Zhuang, Zuojiang	
boz, Inverted name for	Zhuang, Zuojiang	
bpa, Name for	Zhuang, Zuojiang	
bpb, Name for	Zhuang, Zuojiang	
bpd, Name for	Zhuang, Zuojiang	
bpg, Name for	Zhuang, Zuojiang	
bph, Name for	Zhuang, Zuojiang	
bpi, Name for	Zhuang, Zuojiang	
bpj, Name for	Zhuang, Zuojiang	
bpk, Name for	Zhuang, Zuojiang	
bpl, Name for	Zhuang, Zuojiang	
bpm, Name for	Zhuang, Zuojiang	
bpn, Name for	Zhuang, Zuojiang	
bpo, Name for	Zhuang, Zuojiang	
bpp, Name for	Zhuang, Zuojiang	
bpq, Inverted name for	Zhuang, Zuojiang	
bpq, Name for	Zhuang, Zuojiang	
bpr, Inverted name for	Zhuang, Zuojiang	
bps, Inverted name for	Zhuang, Zuojiang	
bpt, Name for	Zhuang, Zuojiang	
bpu, Name for	Zhuang, Zuojiang	
bpv, Inverted name for	Zhuang, Zuojiang	
bpv, Name for	Zhuang, Zuojiang	
bpw, Name for	Zhuang, Zuojiang	
bpx, Inverted name for	Zhuang, Zuojiang	
bpy, Name for	Zhuang, Zuojiang	
bpz, Name for	Zhuang, Zuojiang	
bqa, Name for	Zhuang, Zuojiang	
bqb, Name for	Zhuang, Zuojiang	
bqc, Name for	Zhuang, Zuojiang	
bqd, Name for	Zhuang, Zuojiang	
bqf, Name for	Zhuang, Zuojiang	
bqg, Name for	Zhuang, Zuojiang	
bqh, Name for	Zhuang, Zuojiang	
bqi, Name for	Zhuang, Zuojiang	
bqj, Name for	Zhuang, Zuojiang	
bqk, Name for	Zhuang, Zuojiang	
bql, Name for	Zhuang, Zuojiang	
bqm, Name for	Zhuang, Zuojiang	
bqn, Name for	Zhuang, Zuojiang	
bqo, Name for	Zhuang, Zuojiang	
bqp, Name for	Zhuang, Zuojiang	
bqq, Name for	Zhuang, Zuojiang	
bqr, Name for	Zhuang, Zuojiang	
bqs, Name for	Zhuang, Zuojiang	
bqt, Name for	Zhuang, Zuojiang	
bqu, Name for	Zhuang, Zuojiang	
bqv, Name for	Zhuang, Zuojiang	
bqw, Name for	Zhuang, Zuojiang	
bqx, Name for	Zhuang, Zuojiang	
bqz, Name for	Zhuang, Zuojiang	
bra, Name for	Zhuang, Zuojiang	
brb, Name for	Zhuang, Zuojiang	
brc, Inverted name for	Zhuang, Zuojiang	
brc, Name for	Zhuang, Zuojiang	
brd, Name for	Zhuang, Zuojiang	
bre, Name for	Zhuang, Zuojiang	
brf, Name for	Zhuang, Zuojiang	
brg, Name for	Zhuang, Zuojiang	
brh, Name for	Zhuang, Zuojiang	
bri, Name for	Zhuang, Zuojiang	
brj, Name for	Zhuang, Zuojiang	
brk, Name for	Zhuang, Zuojiang	
brl, Name for	Zhuang, Zuojiang	
brm, Name for	Zhuang, Zuojiang	
brn, Name for	Zhuang, Zuojiang	
bro, Name for	Zhuang, Zuojiang	
brp, Name for	Zhuang, Zuojiang	
brq, Name for	Zhuang, Zuojiang	
brr, Name for	Zhuang, Zuojiang	
brs, Name for	Zhuang, Zuojiang	
brt, Name for	Zhuang, Zuojiang	
bru, Inverted name for	Zhuang, Zuojiang	
bru, Name for	Zhuang, Zuojiang	
brv, Inverted name for	Zhuang, Zuojiang	
brv, Name for	Zhuang, Zuojiang	
brw, Name for	Zhuang, Zuojiang	
brx, Name for	Zhuang, Zuojiang	
bry, Name for	Zhuang, Zuojiang	
brz, Name for	Zhuang, Zuojiang	
bsa, Name for	Zhuang, Zuojiang	
bsb, Inverted name for	Zhuang, Zuojiang	
bsb, Name for	Zhuang, Zuojiang	
bsc, Name for	Zhuang, Zuojiang	
bse, Name for	Zhuang, Zuojiang	
bsf, Name for	Zhuang, Zuojiang	
bsg, Name for	Zhuang, Zuojiang	
bsh, Name for	Zhuang, Zuojiang	
bsi, Name for	Zhuang, Zuojiang	
bsj, Name for	Zhuang, Zuojiang	
bsk, Name for	Zhuang, Zuojiang	
bsl, Name for	Zhuang, Zuojiang	
bsm, Name for	Zhuang, Zuojiang	
bsn, Name for	Zhuang, Zuojiang	
bso, Name for	Zhuang, Zuojiang	
bsp, Name for	Zhuang, Zuojiang	
bsq, Name for	Zhuang, Zuojiang	
bsr, Name for	Zhuang, Zuojiang	
bss, Name for	Zhuang, Zuojiang	
bst, Name for	Zhuang, Zuojiang	
bsu, Name for	Zhuang, Zuojiang	
bsv, Name for	Zhuang, Zuojiang	
bsw, Name for	Zhuang, Zuojiang	
bsx, Name for	Zhuang, Zuojiang	
bsy, Inverted name for	Zhuang, Zuojiang	
bta, Name for	Zhuang, Zuojiang	
btc, Name for	Zhuang, Zuojiang	
btd, Name for	Zhuang, Zuojiang	
bte, Name for	Zhuang, Zuojiang	
btf, Name for	Zhuang, Zuojiang	
btg, Inverted name for	Zhuang, Zuojiang	
bth, Inverted name for	Zhuang, Zuojiang	
bth, Name for	Zhuang, Zuojiang	
bti, Name for	Zhuang, Zuojiang	
btj, Inverted name for	Zhuang, Zuojiang	
btj, Name for	Zhuang, Zuojiang	
btm, Name for	Zhuang, Zuojiang	
btn, Name for	Zhuang, Zuojiang	
btp, Name for	Zhuang, Zuojiang	
btq, Name for	Zhuang, Zuojiang	
btr, Name for	Zhuang, Zuojiang	
bts, Name for	Zhuang, Zuojiang	
btt, Name for	Zhuang, Zuojiang	
btu, Name for	Zhuang, Zuojiang	
btv, Name for	Zhuang, Zuojiang	
btw, Name for	Zhuang, Zuojiang	
btx, Name for	Zhuang, Zuojiang	
bty, Name for	Zhuang, Zuojiang	
btz, Name for	Zhuang, Zuojiang	
bua, Name for	Zhuang, Zuojiang	
bub, Name for	Zhuang, Zuojiang	
buc, Name for	Zhuang, Zuojiang	
bud, Name for	Zhuang, Zuojiang	
bue, Name for	Zhuang, Zuojiang	
buf, Name for	Zhuang, Zuojiang	
bug, Name for	Zhuang, Zuojiang	
buh, Inverted name for	Zhuang, Zuojiang	
buh, Name for	Zhuang, Zuojiang	
bui, Name for	Zhuang, Zuojiang	
buj, Name for	Zhuang, Zuojiang	
buk, Name for	Zhuang, Zuojiang	
bul, Name for	Zhuang, Zuojiang	
bum, Name for	Zhuang, Zuojiang	
bun, Name for	Zhuang, Zuojiang	
buo, Name for	Zhuang, Zuojiang	
bup, Name for	Zhuang, Zuojiang	
buq, Name for	Zhuang, Zuojiang	
bus, Name for	Zhuang, Zuojiang	
but, Name for	Zhuang, Zuojiang	
buw, Name for	Zhuang, Zuojiang	
buz, Name for	Zhuang, Zuojiang	
bva, Name for	Zhuang, Zuojiang	
bvb, Name for	Zhuang, Zuojiang	
bvc, Name for	Zhuang, Zuojiang	
bvh, Name for	Zhuang, Zuojiang	
bvj, Name for	Zhuang, Zuojiang	
bvk, Name for	Zhuang, Zuojiang	
bvl, Name for	Zhuang, Zuojiang	
bvm, Name for	Zhuang, Zuojiang	
bvn, Name for	Zhuang, Zuojiang	
bvo, Name for	Zhuang, Zuojiang	
bvp, Name for	Zhuang, Zuojiang	
bvq, Name for	Zhuang, Zuojiang	
bvr, Name for	Zhuang, Zuojiang	
bvt, Name for	Zhuang, Zuojiang	
bvu, Name for	Zhuang, Zuojiang	
bvv, Name for	Zhuang, Zuojiang	
bvw, Name for	Zhuang, Zuojiang	
bvy, Name for	Zhuang, Zuojiang	
bvz, Name for	Zhuang, Zuojiang	
bwc, Name for	Zhuang, Zuojiang	
bwd, Name for	Zhuang, Zuojiang	
bwe, Inverted name for	Zhuang, Zuojiang	
bwg, Name for	Zhuang, Zuojiang	
bwi, Name for	Zhuang, Zuojiang	
bwk, Name for	Zhuang, Zuojiang	
bwl, Name for	Zhuang, Zuojiang	
bwm, Name for	Zhuang, Zuojiang	
bwp, Name for	Zhuang, Zuojiang	
bwq, Inverted name for	Zhuang, Zuojiang	
bws, Name for	Zhuang, Zuojiang	
bwz, Name for	Zhuang, Zuojiang	
bxa, Name for	Zhuang, Zuojiang	
bxb, Inverted name for	Zhuang, Zuojiang	
bxb, Name for	Zhuang, Zuojiang	
bxc, Name for	Zhuang, Zuojiang	
bxe, Name for	Zhuang, Zuojiang	
bxf, Name for	Zhuang, Zuojiang	
bxg, Name for	Zhuang, Zuojiang	
bxk, Name for	Zhuang, Zuojiang	
bxl, Name for	Zhuang, Zuojiang	
bxm, Inverted name for	Zhuang, Zuojiang	
bxm, Name for	Zhuang, Zuojiang	
bxn, Name for	Zhuang, Zuojiang	
bxo, Name for	Zhuang, Zuojiang	
bxp, Name for	Zhuang, Zuojiang	
bxr, Inverted name for	Zhuang, Zuojiang	
bxr, Name for	Zhuang, Zuojiang	
bxs, Name for	Zhuang, Zuojiang	
bxu, Inverted name for	Zhuang, Zuojiang	
bxu, Name for	Zhuang, Zuojiang	
bxz, Name for	Zhuang, Zuojiang	
bya, Name for	Zhuang, Zuojiang	
byb, Name for	Zhuang, Zuojiang	
byc, Name for	Zhuang, Zuojiang	
bye, Name for	Zhuang, Zuojiang	
byf, Name for	Zhuang, Zuojiang	
byg, Name for	Zhuang, Zuojiang	
byh, Name for	Zhuang, Zuojiang	
byi, Name for	Zhuang, Zuojiang	
byk, Name for	Zhuang, Zuojiang	
byl, Name for	Zhuang, Zuojiang	
bym, Name for	Zhuang, Zuojiang	
byn, Name for	Zhuang, Zuojiang	
byo, Name for	Zhuang, Zuojiang	
byp, Name for	Zhuang, Zuojiang	
byq, Name for	Zhuang, Zuojiang	
byr, Name for	Zhuang, Zuojiang	
bys, Name for	Zhuang, Zuojiang	
byt, Name for	Zhuang, Zuojiang	
byv, Name for	Zhuang, Zuojiang	
byw, Name for	Zhuang, Zuojiang	
byx, Name for	Zhuang, Zuojiang	
byz, Name for	Zhuang, Zuojiang	
bza, Name for	Zhuang, Zuojiang	
bzb, Name for	Zhuang, Zuojiang	
bzd, Name for	Zhuang, Zuojiang	
bze, Inverted name for	Zhuang, Zuojiang	
bzf, Name for	Zhuang, Zuojiang	
bzg, Name for	Zhuang, Zuojiang	
bzh, Inverted name for	Zhuang, Zuojiang	
bzi, Name for	Zhuang, Zuojiang	
bzj, Inverted name for	Zhuang, Zuojiang	
bzj, Name for	Zhuang, Zuojiang	
bzk, Inverted name for	Zhuang, Zuojiang	
bzm, Name for	Zhuang, Zuojiang	
bzo, Name for	Zhuang, Zuojiang	
bzp, Name for	Zhuang, Zuojiang	
bzq, Name for	Zhuang, Zuojiang	
bzr, Name for	Zhuang, Zuojiang	
bzs, Name for	Zhuang, Zuojiang	
bzt, Name for	Zhuang, Zuojiang	
bzu, Name for	Zhuang, Zuojiang	
bzv, Name for	Zhuang, Zuojiang	
bzw, Name for	Zhuang, Zuojiang	
bzy, Name for	Zhuang, Zuojiang	
bzz, Name for	Zhuang, Zuojiang	
caa, Name for	Zhuang, Zuojiang	
cab, Name for	Zhuang, Zuojiang	
cac, Name for	Zhuang, Zuojiang	
cad, Name for	Zhuang, Zuojiang	
cae, Name for	Zhuang, Zuojiang	
caf, Inverted name for	Zhuang, Zuojiang	
cag, Name for	Zhuang, Zuojiang	
cah, Name for	Zhuang, Zuojiang	
caj, Name for	Zhuang, Zuojiang	
cak, Name for	Zhuang, Zuojiang	
cal, Name for	Zhuang, Zuojiang	
cam, Name for	Zhuang, Zuojiang	
can, Name for	Zhuang, Zuojiang	
cao, Name for	Zhuang, Zuojiang	
cap, Name for	Zhuang, Zuojiang	
car, Name for	Zhuang, Zuojiang	
cas, Name for	Zhuang, Zuojiang	
cat, Name for	Zhuang, Zuojiang	
cav, Name for	Zhuang, Zuojiang	
caw, Name for	Zhuang, Zuojiang	
cax, Name for	Zhuang, Zuojiang	
cay, Name for	Zhuang, Zuojiang	
caz, Name for	Zhuang, Zuojiang	
cbb, Name for	Zhuang, Zuojiang	
cbc, Name for	Zhuang, Zuojiang	
cbd, Name for	Zhuang, Zuojiang	
cbg, Name for	Zhuang, Zuojiang	
cbi, Name for	Zhuang, Zuojiang	
cbk, Name for	Zhuang, Zuojiang	
cbl, Name for	Zhuang, Zuojiang	
cbn, Name for	Zhuang, Zuojiang	
cbo, Name for	Zhuang, Zuojiang	
cbs, Name for	Zhuang, Zuojiang	
cbt, Name for	Zhuang, Zuojiang	
cbv, Name for	Zhuang, Zuojiang	
cbw, Name for	Zhuang, Zuojiang	
cby, Name for	Zhuang, Zuojiang	
cca, Name for	Zhuang, Zuojiang	
ccc, Name for	Zhuang, Zuojiang	
cce, Name for	Zhuang, Zuojiang	
ccg, Inverted name for	Zhuang, Zuojiang	
ccg, Name for	Zhuang, Zuojiang	
cch, Name for	Zhuang, Zuojiang	
ccj, Name for	Zhuang, Zuojiang	
ccl, Name for	Zhuang, Zuojiang	
ccm, Name for	Zhuang, Zuojiang	
ccp, Name for	Zhuang, Zuojiang	
ccr, Name for	Zhuang, Zuojiang	
cda, Name for	Zhuang, Zuojiang	
cde, Name for	Zhuang, Zuojiang	
cdf, Name for	Zhuang, Zuojiang	
cdg, Name for	Zhuang, Zuojiang	
cdh, Name for	Zhuang, Zuojiang	
cdi, Name for	Zhuang, Zuojiang	
cdj, Name for	Zhuang, Zuojiang	
cdm, Name for	Zhuang, Zuojiang	
cdn, Name for	Zhuang, Zuojiang	
cdo, Name for	Zhuang, Zuojiang	
cds, Name for	Zhuang, Zuojiang	
cdy, Name for	Zhuang, Zuojiang	
cdz, Name for	Zhuang, Zuojiang	
ceb, Name for	Zhuang, Zuojiang	
ceg, Name for	Zhuang, Zuojiang	
cek, Inverted name for	Zhuang, Zuojiang	
cek, Name for	Zhuang, Zuojiang	
cen, Name for	Zhuang, Zuojiang	
ces, Name for	Zhuang, Zuojiang	
cet, Name for	Zhuang, Zuojiang	
cfa, Name for	Zhuang, Zuojiang	
cfd, Name for	Zhuang, Zuojiang	
cfm, Name for	Zhuang, Zuojiang	
cgg, Name for	Zhuang, Zuojiang	
cha, Name for	Zhuang, Zuojiang	
chb, Name for	Zhuang, Zuojiang	
chc, Name for	Zhuang, Zuojiang	
che, Name for	Zhuang, Zuojiang	
chg, Name for	Zhuang, Zuojiang	
chh, Name for	Zhuang, Zuojiang	
chk, Name for	Zhuang, Zuojiang	
chm, Name for	Zhuang, Zuojiang	
chn, Name for	Zhuang, Zuojiang	
cho, Name for	Zhuang, Zuojiang	
chp, Name for	Zhuang, Zuojiang	
chr, Name for	Zhuang, Zuojiang	
chu, Name for	Zhuang, Zuojiang	
chv, Name for	Zhuang, Zuojiang	
chx, Name for	Zhuang, Zuojiang	
chy, Name for	Zhuang, Zuojiang	
cic, Name for	Zhuang, Zuojiang	
cie, Name for	Zhuang, Zuojiang	
cik, Name for	Zhuang, Zuojiang	
cim, Name for	Zhuang, Zuojiang	
cip, Name for	Zhuang, Zuojiang	
cir, Name for	Zhuang, Zuojiang	
ciw, Name for	Zhuang, Zuojiang	
ciy, Name for	Zhuang, Zuojiang	
cja, Name for	Zhuang, Zuojiang	
cji, Name for	Zhuang, Zuojiang	
cjk, Name for	Zhuang, Zuojiang	
cjn, Name for	Zhuang, Zuojiang	
cjs, Name for	Zhuang, Zuojiang	
cjv, Name for	Zhuang, Zuojiang	
cjy, Inverted name for	Zhuang, Zuojiang	
cjy, Name for	Zhuang, Zuojiang	
ckb, Inverted name for	Zhuang, Zuojiang	
ckb, Name for	Zhuang, Zuojiang	
ckh, Name for	Zhuang, Zuojiang	
ckt, Name for	Zhuang, Zuojiang	
cku, Name for	Zhuang, Zuojiang	
ckv, Name for	Zhuang, Zuojiang	
cla, Name for	Zhuang, Zuojiang	
cli, Name for	Zhuang, Zuojiang	
clm, Name for	Zhuang, Zuojiang	
clu, Name for	Zhuang, Zuojiang	
cma, Name for	Zhuang, Zuojiang	
cme, Name for	Zhuang, Zuojiang	
cmg, Inverted name for	Zhuang, Zuojiang	
cmg, Name for	Zhuang, Zuojiang	
cmo, Name for	Zhuang, Zuojiang	
cns, Name for	Zhuang, Zuojiang	
cof, Name for	Zhuang, Zuojiang	
com, Name for	Zhuang, Zuojiang	
cop, Name for	Zhuang, Zuojiang	
cor, Name for	Zhuang, Zuojiang	
cos, Name for	Zhuang, Zuojiang	
cpi, Inverted name for	Zhuang, Zuojiang	
cpi, Name for	Zhuang, Zuojiang	
cre, Name for	Zhuang, Zuojiang	
crs, Inverted name for	Zhuang, Zuojiang	
crs, Name for	Zhuang, Zuojiang	
csb, Name for	Zhuang, Zuojiang	
cse, Name for	Zhuang, Zuojiang	
csf, Name for	Zhuang, Zuojiang	
csg, Name for	Zhuang, Zuojiang	
csl, Name for	Zhuang, Zuojiang	
csq, Name for	Zhuang, Zuojiang	
cym, Name for	Zhuang, Zuojiang	
dak, Name for	Zhuang, Zuojiang	
dan, Name for	Zhuang, Zuojiang	
dar, Name for	Zhuang, Zuojiang	
dbj, Name for	Zhuang, Zuojiang	
del, Name for	Zhuang, Zuojiang	
den, Name for	Zhuang, Zuojiang	
deu, Name for	Zhuang, Zuojiang	
dgr, Name for	Zhuang, Zuojiang	
din, Name for	Zhuang, Zuojiang	
dlm, Name for	Zhuang, Zuojiang	
doh, Name for	Zhuang, Zuojiang	
dsb, Inverted name for	Zhuang, Zuojiang	
dsb, Name for	Zhuang, Zuojiang	
dse, Name for	Zhuang, Zuojiang	
dsi, Name for	Zhuang, Zuojiang	
dsl, Name for	Zhuang, Zuojiang	
dso, Name for	Zhuang, Zuojiang	
dua, Name for	Zhuang, Zuojiang	
dum, Inverted name for	Zhuang, Zuojiang	
dum, Name for	Zhuang, Zuojiang	
dyu, Name for	Zhuang, Zuojiang	
dzo, Name for	Zhuang, Zuojiang	
ebu, Name for	Zhuang, Zuojiang	
efi, Name for	Zhuang, Zuojiang	
egy, Name for	Zhuang, Zuojiang	
eka, Name for	Zhuang, Zuojiang	
ell, Inverted name for	Zhuang, Zuojiang	
elx, Name for	Zhuang, Zuojiang	
eng, Name for	Zhuang, Zuojiang	
enm, Inverted name for	Zhuang, Zuojiang	
enm, Name for	Zhuang, Zuojiang	
enq, Name for	Zhuang, Zuojiang	
epo, Name for	Zhuang, Zuojiang	
esi, Inverted name for	Zhuang, Zuojiang	
esi, Name for	Zhuang, Zuojiang	
esk, Inverted name for	Zhuang, Zuojiang	
esk, Name for	Zhuang, Zuojiang	
esl, Name for	Zhuang, Zuojiang	
eso, Name for	Zhuang, Zuojiang	
est, Name for	Zhuang, Zuojiang	
eus, Name for	Zhuang, Zuojiang	
ewe, Name for	Zhuang, Zuojiang	
ewo, Name for	Zhuang, Zuojiang	
fao, Name for	Zhuang, Zuojiang	
fas, Name for	Zhuang, Zuojiang	
fat, Name for	Zhuang, Zuojiang	
fcs, Name for	Zhuang, Zuojiang	
fij, Name for	Zhuang, Zuojiang	
fin, Name for	Zhuang, Zuojiang	
fon, Name for	Zhuang, Zuojiang	
fra, Name for	Zhuang, Zuojiang	
frc, Inverted name for	Zhuang, Zuojiang	
frc, Name for	Zhuang, Zuojiang	
frk, Name for	Zhuang, Zuojiang	
frm, Inverted name for	Zhuang, Zuojiang	
frm, Name for	Zhuang, Zuojiang	
fro, Inverted name for	Zhuang, Zuojiang	
fro, Name for	Zhuang, Zuojiang	
frr, Name for	Zhuang, Zuojiang	
frs, Name for	Zhuang, Zuojiang	
fse, Name for	Zhuang, Zuojiang	
fsl, Name for	Zhuang, Zuojiang	
fss, Name for	Zhuang, Zuojiang	
ful, Name for	Zhuang, Zuojiang	
fur, Name for	Zhuang, Zuojiang	
gaa, Name for	Zhuang, Zuojiang	
gay, Name for	Zhuang, Zuojiang	
gcc, Name for	Zhuang, Zuojiang	
gcf, Inverted name for	Zhuang, Zuojiang	
gcf, Name for	Zhuang, Zuojiang	
gcr, Inverted name for	Zhuang, Zuojiang	
gcr, Name for	Zhuang, Zuojiang	
gct, Inverted name for	Zhuang, Zuojiang	
gct, Name for	Zhuang, Zuojiang	
gds, Name for	Zhuang, Zuojiang	
gea, Name for	Zhuang, Zuojiang	
geh, Inverted name for	Zhuang, Zuojiang	
geh, Name for	Zhuang, Zuojiang	
gej, Name for	Zhuang, Zuojiang	
gew, Name for	Zhuang, Zuojiang	
gez, Name for	Zhuang, Zuojiang	
gga, Name for	Zhuang, Zuojiang	
ghr, Name for	Zhuang, Zuojiang	
gil, Name for	Zhuang, Zuojiang	
gis, Inverted name for	Zhuang, Zuojiang	
gis, Name for	Zhuang, Zuojiang	
giz, Inverted name for	Zhuang, Zuojiang	
giz, Name for	Zhuang, Zuojiang	
gle, Name for	Zhuang, Zuojiang	
glg, Name for	Zhuang, Zuojiang	
glh, Inverted name for	Zhuang, Zuojiang	
glh, Name for	Zhuang, Zuojiang	
glu, Name for	Zhuang, Zuojiang	
glv, Name for	Zhuang, Zuojiang	
gmh, Inverted name for	Zhuang, Zuojiang	
gmh, Name for	Zhuang, Zuojiang	
gml, Inverted name for	Zhuang, Zuojiang	
gml, Name for	Zhuang, Zuojiang	
gmm, Name for	Zhuang, Zuojiang	
gmn, Name for	Zhuang, Zuojiang	
gmu, Name for	Zhuang, Zuojiang	
gmv, Name for	Zhuang, Zuojiang	
gmx, Name for	Zhuang, Zuojiang	
gmy, Inverted name for	Zhuang, Zuojiang	
gmy, Name for	Zhuang, Zuojiang	
gmz, Name for	Zhuang, Zuojiang	
gna, Name for	Zhuang, Zuojiang	
gnb, Name for	Zhuang, Zuojiang	
gnc, Name for	Zhuang, Zuojiang	
gnd, Name for	Zhuang, Zuojiang	
gne, Name for	Zhuang, Zuojiang	
gng, Name for	Zhuang, Zuojiang	
gnh, Name for	Zhuang, Zuojiang	
gni, Name for	Zhuang, Zuojiang	
gnm, Name for	Zhuang, Zuojiang	
goh, Inverted name for	Zhuang, Zuojiang	
goh, Name for	Zhuang, Zuojiang	
gok, Name for	Zhuang, Zuojiang	
gol, Name for	Zhuang, Zuojiang	
gon, Name for	Zhuang, Zuojiang	
gor, Name for	Zhuang, Zuojiang	
got, Name for	Zhuang, Zuojiang	
gpe, Inverted name for	Zhuang, Zuojiang	
gpe, Name for	Zhuang, Zuojiang	
grb, Name for	Zhuang, Zuojiang	
grc, Inverted name for	Zhuang, Zuojiang	
grn, Name for	Zhuang, Zuojiang	
gro, Name for	Zhuang, Zuojiang	
grv, Inverted name for	Zhuang, Zuojiang	
gse, Name for	Zhuang, Zuojiang	
gsg, Name for	Zhuang, Zuojiang	
gss, Name for	Zhuang, Zuojiang	
gsw, Inverted name for	Zhuang, Zuojiang	
gsw, Name for	Zhuang, Zuojiang	
gug, Name for	Zhuang, Zuojiang	
guj, Name for	Zhuang, Zuojiang	
gus, Name for	Zhuang, Zuojiang	
gve, Name for	Zhuang, Zuojiang	
gvm, Name for	Zhuang, Zuojiang	
gye, Name for	Zhuang, Zuojiang	
hab, Name for	Zhuang, Zuojiang	
haf, Name for	Zhuang, Zuojiang	
hai, Name for	Zhuang, Zuojiang	
haq, Name for	Zhuang, Zuojiang	
hau, Name for	Zhuang, Zuojiang	
haw, Name for	Zhuang, Zuojiang	
hds, Name for	Zhuang, Zuojiang	
heb, Name for	Zhuang, Zuojiang	
her, Name for	Zhuang, Zuojiang	
hil, Name for	Zhuang, Zuojiang	
hin, Name for	Zhuang, Zuojiang	
hit, Name for	Zhuang, Zuojiang	
hks, Name for	Zhuang, Zuojiang	
hmj, Name for	Zhuang, Zuojiang	
hmn, Name for	Zhuang, Zuojiang	
hmo, Name for	Zhuang, Zuojiang	
hps, Name for	Zhuang, Zuojiang	
hrv, Name for	Zhuang, Zuojiang	
hsb, Name for	Zhuang, Zuojiang	
hsh, Name for	Zhuang, Zuojiang	
hun, Name for	Zhuang, Zuojiang	
hup, Name for	Zhuang, Zuojiang	
hye, Name for	Zhuang, Zuojiang	
iba, Name for	Zhuang, Zuojiang	
ibl, Name for	Zhuang, Zuojiang	
ibo, Name for	Zhuang, Zuojiang	
icl, Name for	Zhuang, Zuojiang	
ido, Name for	Zhuang, Zuojiang	
ign, Name for	Zhuang, Zuojiang	
iku, Name for	Zhuang, Zuojiang	
ilb, Name for	Zhuang, Zuojiang	
ile, Name for	Zhuang, Zuojiang	
ilo, Name for	Zhuang, Zuojiang	
ina, Name for	Zhuang, Zuojiang	
ind, Name for	Zhuang, Zuojiang	
inh, Name for	Zhuang, Zuojiang	
inl, Name for	Zhuang, Zuojiang	
ins, Name for	Zhuang, Zuojiang	
ipk, Name for	Zhuang, Zuojiang	
iqu, Name for	Zhuang, Zuojiang	
ise, Name for	Zhuang, Zuojiang	
isg, Name for	Zhuang, Zuojiang	
isl, Name for	Zhuang, Zuojiang	
isr, Name for	Zhuang, Zuojiang	
ita, Name for	Zhuang, Zuojiang	
itk, Name for	Zhuang, Zuojiang	
itv, Name for	Zhuang, Zuojiang	
jav, Name for	Zhuang, Zuojiang	
jbo, Name for	Zhuang, Zuojiang	
jhi, Name for	Zhuang, Zuojiang	
jib, Name for	Zhuang, Zuojiang	
jid, Name for	Zhuang, Zuojiang	
jie, Name for	Zhuang, Zuojiang	
jig, Name for	Zhuang, Zuojiang	
jit, Name for	Zhuang, Zuojiang	
jiv, Name for	Zhuang, Zuojiang	
jkm, Name for	Zhuang, Zuojiang	
jls, Name for	Zhuang, Zuojiang	
jpn, Name for	Zhuang, Zuojiang	
jpr, Name for	Zhuang, Zuojiang	
jrb, Name for	Zhuang, Zuojiang	
jsl, Name for	Zhuang, Zuojiang	
juc, Name for	Zhuang, Zuojiang	
kaa, Name for	Zhuang, Zuojiang	
kab, Name for	Zhuang, Zuojiang	
kac, Name for	Zhuang, Zuojiang	
kan, Name for	Zhuang, Zuojiang	
kas, Name for	Zhuang, Zuojiang	
kat, Name for	Zhuang, Zuojiang	
kau, Name for	Zhuang, Zuojiang	
kaw, Name for	Zhuang, Zuojiang	
kaz, Name for	Zhuang, Zuojiang	
kbv, Name for	Zhuang, Zuojiang	
kcp, Name for	Zhuang, Zuojiang	
kcu, Name for	Zhuang, Zuojiang	
kfe, Name for	Zhuang, Zuojiang	
kgv, Name for	Zhuang, Zuojiang	
kha, Name for	Zhuang, Zuojiang	
khm, Inverted name for	Zhuang, Zuojiang	
khm, Name for	Zhuang, Zuojiang	
kho, Name for	Zhuang, Zuojiang	
kik, Name for	Zhuang, Zuojiang	
kin, Name for	Zhuang, Zuojiang	
kir, Name for	Zhuang, Zuojiang	
kiu, Name for	Zhuang, Zuojiang	
kmb, Name for	Zhuang, Zuojiang	
kmd, Inverted name for	Zhuang, Zuojiang	
kmd, Name for	Zhuang, Zuojiang	
kmk, Inverted name for	Zhuang, Zuojiang	
kmk, Name for	Zhuang, Zuojiang	
kml, Inverted name for	Zhuang, Zuojiang	
kml, Name for	Zhuang, Zuojiang	
kmv, Inverted name for	Zhuang, Zuojiang	
kmv, Name for	Zhuang, Zuojiang	
knb, Inverted name for	Zhuang, Zuojiang	
knb, Name for	Zhuang, Zuojiang	
knc, Name for	Zhuang, Zuojiang	
knn, Name for	Zhuang, Zuojiang	
kom, Name for	Zhuang, Zuojiang	
kon, Name for	Zhuang, Zuojiang	
kor, Name for	Zhuang, Zuojiang	
kos, Name for	Zhuang, Zuojiang	
kpe, Name for	Zhuang, Zuojiang	
kqs, Inverted name for	Zhuang, Zuojiang	
kqs, Name for	Zhuang, Zuojiang	
krc, Name for	Zhuang, Zuojiang	
krh, Name for	Zhuang, Zuojiang	
kri, Name for	Zhuang, Zuojiang	
krl, Name for	Zhuang, Zuojiang	
kru, Name for	Zhuang, Zuojiang	
ksc, Inverted name for	Zhuang, Zuojiang	
ksc, Name for	Zhuang, Zuojiang	
ksr, Name for	Zhuang, Zuojiang	
kua, Name for	Zhuang, Zuojiang	
kum, Name for	Zhuang, Zuojiang	
kur, Name for	Zhuang, Zuojiang	
kut, Name for	Zhuang, Zuojiang	
kvd, Name for	Zhuang, Zuojiang	
kvk, Name for	Zhuang, Zuojiang	
kvt, Name for	Zhuang, Zuojiang	
kxl, Inverted name for	Zhuang, Zuojiang	
kxm, Inverted name for	Zhuang, Zuojiang	
kxm, Name for	Zhuang, Zuojiang	
lab, Name for	Zhuang, Zuojiang	
lad, Name for	Zhuang, Zuojiang	
lae, Name for	Zhuang, Zuojiang	
lah, Name for	Zhuang, Zuojiang	
lam, Name for	Zhuang, Zuojiang	
lao, Name for	Zhuang, Zuojiang	
lap, Name for	Zhuang, Zuojiang	
lat, Name for	Zhuang, Zuojiang	
lav, Name for	Zhuang, Zuojiang	
lbk, Inverted name for	Zhuang, Zuojiang	
lbk, Name for	Zhuang, Zuojiang	
lbs, Name for	Zhuang, Zuojiang	
lcd, Name for	Zhuang, Zuojiang	
lez, Name for	Zhuang, Zuojiang	
lhh, Name for	Zhuang, Zuojiang	
lif, Name for	Zhuang, Zuojiang	
lin, Name for	Zhuang, Zuojiang	
lir, Name for	Zhuang, Zuojiang	
lit, Name for	Zhuang, Zuojiang	
llh, Name for	Zhuang, Zuojiang	
lln, Name for	Zhuang, Zuojiang	
lls, Name for	Zhuang, Zuojiang	
lol, Name for	Zhuang, Zuojiang	
loz, Name for	Zhuang, Zuojiang	
lrl, Name for	Zhuang, Zuojiang	
lsg, Name for	Zhuang, Zuojiang	
lsl, Name for	Zhuang, Zuojiang	
lsp, Name for	Zhuang, Zuojiang	
lst, Name for	Zhuang, Zuojiang	
lsy, Name for	Zhuang, Zuojiang	
lti, Name for	Zhuang, Zuojiang	
lua, Name for	Zhuang, Zuojiang	
lub, Name for	Zhuang, Zuojiang	
lug, Name for	Zhuang, Zuojiang	
lui, Name for	Zhuang, Zuojiang	
lun, Name for	Zhuang, Zuojiang	
luo, Name for	Zhuang, Zuojiang	
lus, Name for	Zhuang, Zuojiang	
luw, Name for	Zhuang, Zuojiang	
mad, Name for	Zhuang, Zuojiang	
mag, Name for	Zhuang, Zuojiang	
mah, Name for	Zhuang, Zuojiang	
mai, Name for	Zhuang, Zuojiang	
mak, Name for	Zhuang, Zuojiang	
mal, Name for	Zhuang, Zuojiang	
man, Name for	Zhuang, Zuojiang	
mar, Name for	Zhuang, Zuojiang	
mas, Name for	Zhuang, Zuojiang	
maz, Inverted name for	Zhuang, Zuojiang	
maz, Name for	Zhuang, Zuojiang	
mcw, Name for	Zhuang, Zuojiang	
mde, Name for	Zhuang, Zuojiang	
mdf, Name for	Zhuang, Zuojiang	
mdl, Name for	Zhuang, Zuojiang	
mdr, Name for	Zhuang, Zuojiang	
mec, Name for	Zhuang, Zuojiang	
mel, Name for	Zhuang, Zuojiang	
mer, Name for	Zhuang, Zuojiang	
mfs, Name for	Zhuang, Zuojiang	
mfy, Name for	Zhuang, Zuojiang	
mga, Inverted name for	Zhuang, Zuojiang	
mga, Name for	Zhuang, Zuojiang	
mgs, Name for	Zhuang, Zuojiang	
mha, Name for	Zhuang, Zuojiang	
mhs, Name for	Zhuang, Zuojiang	
mhz, Name for	Zhuang, Zuojiang	
min, Name for	Zhuang, Zuojiang	
mis, Name for	Zhuang, Zuojiang	
mjh, Name for	Zhuang, Zuojiang	
mkd, Name for	Zhuang, Zuojiang	
mlg, Name for	Zhuang, Zuojiang	
mlt, Name for	Zhuang, Zuojiang	
mnc, Name for	Zhuang, Zuojiang	
mni, Name for	Zhuang, Zuojiang	
mnw, Name for	Zhuang, Zuojiang	
moh, Name for	Zhuang, Zuojiang	
mon, Name for	Zhuang, Zuojiang	
mos, Name for	Zhuang, Zuojiang	
mpk, Name for	Zhuang, Zuojiang	
mqa, Name for	Zhuang, Zuojiang	
mri, Name for	Zhuang, Zuojiang	
mrr, Name for	Zhuang, Zuojiang	
msr, Name for	Zhuang, Zuojiang	
mtn, Name for	Zhuang, Zuojiang	
mul, Name for	Zhuang, Zuojiang	
mus, Name for	Zhuang, Zuojiang	
mvw, Name for	Zhuang, Zuojiang	
mwl, Name for	Zhuang, Zuojiang	
mwr, Name for	Zhuang, Zuojiang	
mxn, Name for	Zhuang, Zuojiang	
mya, Name for	Zhuang, Zuojiang	
myi, Name for	Zhuang, Zuojiang	
myv, Name for	Zhuang, Zuojiang	
mzg, Name for	Zhuang, Zuojiang	
nap, Name for	Zhuang, Zuojiang	
nau, Name for	Zhuang, Zuojiang	
nbl, Inverted name for	Zhuang, Zuojiang	
nbl, Name for	Zhuang, Zuojiang	
ncs, Name for	Zhuang, Zuojiang	
nde, Inverted name for	Zhuang, Zuojiang	
nde, Name for	Zhuang, Zuojiang	
ndo, Name for	Zhuang, Zuojiang	
nds, Inverted name for	Zhuang, Zuojiang	
nds, Name for	Zhuang, Zuojiang	
neg, Name for	Zhuang, Zuojiang	
ner, Name for	Zhuang, Zuojiang	
ney, Name for	Zhuang, Zuojiang	
nfa, Name for	Zhuang, Zuojiang	
nge, Name for	Zhuang, Zuojiang	
ngi, Name for	Zhuang, Zuojiang	
nia, Name for	Zhuang, Zuojiang	
nih, Name for	Zhuang, Zuojiang	
nil, Name for	Zhuang, Zuojiang	
nim, Name for	Zhuang, Zuojiang	
nio, Name for	Zhuang, Zuojiang	
niq, Name for	Zhuang, Zuojiang	
nir, Name for	Zhuang, Zuojiang	
nis, Name for	Zhuang, Zuojiang	
nit, Inverted name for	Zhuang, Zuojiang	
nit, Name for	Zhuang, Zuojiang	
niu, Name for	Zhuang, Zuojiang	
niw, Name for	Zhuang, Zuojiang	
nix, Name for	Zhuang, Zuojiang	
niy, Name for	Zhuang, Zuojiang	
niz, Name for	Zhuang, Zuojiang	
nji, Name for	Zhuang, Zuojiang	
njm, Name for	Zhuang, Zuojiang	
njn, Name for	Zhuang, Zuojiang	
njs, Name for	Zhuang, Zuojiang	
njx, Name for	Zhuang, Zuojiang	
njz, Name for	Zhuang, Zuojiang	
nka, Name for	Zhuang, Zuojiang	
nkc, Name for	Zhuang, Zuojiang	
nkd, Name for	Zhuang, Zuojiang	
nkg, Name for	Zhuang, Zuojiang	
nki, Name for	Zhuang, Zuojiang	
nkj, Name for	Zhuang, Zuojiang	
nkm, Name for	Zhuang, Zuojiang	
nkn, Name for	Zhuang, Zuojiang	
nko, Name for	Zhuang, Zuojiang	
nkq, Name for	Zhuang, Zuojiang	
nkr, Name for	Zhuang, Zuojiang	
nkt, Name for	Zhuang, Zuojiang	
nku, Name for	Zhuang, Zuojiang	
nkw, Name for	Zhuang, Zuojiang	
nkx, Name for	Zhuang, Zuojiang	
nkz, Name for	Zhuang, Zuojiang	
nlc, Name for	Zhuang, Zuojiang	
nld, Name for	Zhuang, Zuojiang	
nno, Name for	Zhuang, Zuojiang	
nob, Name for	Zhuang, Zuojiang	
nod, Inverted name for	Zhuang, Zuojiang	
nog, Name for	Zhuang, Zuojiang	
non, Inverted name for	Zhuang, Zuojiang	
nor, Name for	Zhuang, Zuojiang	
nqo, Name for	Zhuang, Zuojiang	
nrb, Name for	Zhuang, Zuojiang	
nsi, Name for	Zhuang, Zuojiang	
nsp, Name for	Zhuang, Zuojiang	
nsr, Name for	Zhuang, Zuojiang	
nyf, Name for	Zhuang, Zuojiang	
nyj, Name for	Zhuang, Zuojiang	
nym, Name for	Zhuang, Zuojiang	
nyn, Name for	Zhuang, Zuojiang	
nyo, Name for	Zhuang, Zuojiang	
nzi, Name for	Zhuang, Zuojiang	
nzs, Name for	Zhuang, Zuojiang	
oar, Inverted name for	Zhuang, Zuojiang	
oar, Name for	Zhuang, Zuojiang	
oav, Inverted name for	Zhuang, Zuojiang	
oav, Name for	Zhuang, Zuojiang	
obt, Inverted name for	Zhuang, Zuojiang	
obt, Name for	Zhuang, Zuojiang	
oci, Name for	Zhuang, Zuojiang	
odt, Inverted name for	Zhuang, Zuojiang	
odt, Name for	Zhuang, Zuojiang	
oge, Inverted name for	Zhuang, Zuojiang	
oge, Name for	Zhuang, Zuojiang	
ohu, Name for	Zhuang, Zuojiang	
oji, Name for	Zhuang, Zuojiang	
okl, Inverted name for	Zhuang, Zuojiang	
okl, Name for	Zhuang, Zuojiang	
okm, Inverted name for	Zhuang, Zuojiang	
okm, Name for	Zhuang, Zuojiang	
oko, Inverted name for	Zhuang, Zuojiang	
oko, Name for	Zhuang, Zuojiang	
omx, Inverted name for	Zhuang, Zuojiang	
oos, Inverted name for	Zhuang, Zuojiang	
orm, Name for	Zhuang, Zuojiang	
ort, Inverted name for	Zhuang, Zuojiang	
osa, Name for	Zhuang, Zuojiang	
osx, Inverted name for	Zhuang, Zuojiang	
ota, Inverted name for	Zhuang, Zuojiang	
ota, Name for	Zhuang, Zuojiang	
oui, Inverted name for	Zhuang, Zuojiang	
oui, Name for	Zhuang, Zuojiang	
pag, Name for	Zhuang, Zuojiang	
pal, Name for	Zhuang, Zuojiang	
pam, Name for	Zhuang, Zuojiang	
pap, Name for	Zhuang, Zuojiang	
pau, Name for	Zhuang, Zuojiang	
pbv, Name for	Zhuang, Zuojiang	
pcb, Name for	Zhuang, Zuojiang	
pce, Inverted name for	Zhuang, Zuojiang	
pce, Name for	Zhuang, Zuojiang	
pcf, Name for	Zhuang, Zuojiang	
pcg, Name for	Zhuang, Zuojiang	
pch, Name for	Zhuang, Zuojiang	
pci, Name for	Zhuang, Zuojiang	
pcj, Name for	Zhuang, Zuojiang	
pck, Inverted name for	Zhuang, Zuojiang	
pck, Name for	Zhuang, Zuojiang	
pcl, Name for	Zhuang, Zuojiang	
pcm, Inverted name for	Zhuang, Zuojiang	
pcm, Name for	Zhuang, Zuojiang	
pcn, Name for	Zhuang, Zuojiang	
pcp, Name for	Zhuang, Zuojiang	
pcw, Name for	Zhuang, Zuojiang	
pda, Name for	Zhuang, Zuojiang	
pdc, Inverted name for	Zhuang, Zuojiang	
pdc, Name for	Zhuang, Zuojiang	
peo, Inverted name for	Zhuang, Zuojiang	
peo, Name for	Zhuang, Zuojiang	
pep, Name for	Zhuang, Zuojiang	
pgl, Inverted name for	Zhuang, Zuojiang	
pgl, Name for	Zhuang, Zuojiang	
pgz, Name for	Zhuang, Zuojiang	
phn, Name for	Zhuang, Zuojiang	
pks, Name for	Zhuang, Zuojiang	
pli, Name for	Zhuang, Zuojiang	
pol, Name for	Zhuang, Zuojiang	
pon, Name for	Zhuang, Zuojiang	
por, Name for	Zhuang, Zuojiang	
prf, Name for	Zhuang, Zuojiang	
prl, Name for	Zhuang, Zuojiang	
pro, Inverted name for	Zhuang, Zuojiang	
psc, Name for	Zhuang, Zuojiang	
psh, Inverted name for	Zhuang, Zuojiang	
psh, Name for	Zhuang, Zuojiang	
psi, Inverted name for	Zhuang, Zuojiang	
psi, Name for	Zhuang, Zuojiang	
pso, Name for	Zhuang, Zuojiang	
psp, Name for	Zhuang, Zuojiang	
psr, Name for	Zhuang, Zuojiang	
pus, Name for	Zhuang, Zuojiang	
pys, Name for	Zhuang, Zuojiang	
que, Name for	Zhuang, Zuojiang	
raj, Name for	Zhuang, Zuojiang	
rap, Name for	Zhuang, Zuojiang	
rcf, Inverted name for	Zhuang, Zuojiang	
rcf, Name for	Zhuang, Zuojiang	
reg, Name for	Zhuang, Zuojiang	
ria, Name for	Zhuang, Zuojiang	
rki, Name for	Zhuang, Zuojiang	
rmc, Inverted name for	Zhuang, Zuojiang	
rmc, Name for	Zhuang, Zuojiang	
rmd, Inverted name for	Zhuang, Zuojiang	
rmd, Name for	Zhuang, Zuojiang	
rmg, Inverted name for	Zhuang, Zuojiang	
rmg, Name for	Zhuang, Zuojiang	
rml, Inverted name for	Zhuang, Zuojiang	
rml, Name for	Zhuang, Zuojiang	
rmm, Name for	Zhuang, Zuojiang	
rmn, Inverted name for	Zhuang, Zuojiang	
rmn, Name for	Zhuang, Zuojiang	
rmo, Inverted name for	Zhuang, Zuojiang	
rmo, Name for	Zhuang, Zuojiang	
rms, Name for	Zhuang, Zuojiang	
rmu, Inverted name for	Zhuang, Zuojiang	
rmu, Name for	Zhuang, Zuojiang	
rmw, Inverted name for	Zhuang, Zuojiang	
rmw, Name for	Zhuang, Zuojiang	
rmy, Inverted name for	Zhuang, Zuojiang	
rmy, Name for	Zhuang, Zuojiang	
roh, Name for	Zhuang, Zuojiang	
rom, Name for	Zhuang, Zuojiang	
ron, Name for	Zhuang, Zuojiang	
rsi, Name for	Zhuang, Zuojiang	
rsl, Name for	Zhuang, Zuojiang	
ruk, Name for	Zhuang, Zuojiang	
run, Name for	Zhuang, Zuojiang	
ruo, Inverted name for	Zhuang, Zuojiang	
ruo, Name for	Zhuang, Zuojiang	
rup, Inverted name for	Zhuang, Zuojiang	
rup, Name for	Zhuang, Zuojiang	
ruq, Inverted name for	Zhuang, Zuojiang	
ruq, Name for	Zhuang, Zuojiang	
rus, Name for	Zhuang, Zuojiang	
rut, Name for	Zhuang, Zuojiang	
ruu, Inverted name for	Zhuang, Zuojiang	
ruy, Name for	Zhuang, Zuojiang	
ruz, Name for	Zhuang, Zuojiang	
rwa, Name for	Zhuang, Zuojiang	
rwk, Name for	Zhuang, Zuojiang	
rwr, Name for	Zhuang, Zuojiang	
saa, Name for	Zhuang, Zuojiang	
sad, Name for	Zhuang, Zuojiang	
sag, Name for	Zhuang, Zuojiang	
sah, Name for	Zhuang, Zuojiang	
sam, Name for	Zhuang, Zuojiang	
san, Name for	Zhuang, Zuojiang	
saq, Name for	Zhuang, Zuojiang	
sas, Name for	Zhuang, Zuojiang	
sat, Name for	Zhuang, Zuojiang	
saz, Name for	Zhuang, Zuojiang	
sbi, Name for	Zhuang, Zuojiang	
sbp, Name for	Zhuang, Zuojiang	
scf, Inverted name for	Zhuang, Zuojiang	
scf, Name for	Zhuang, Zuojiang	
scn, Name for	Zhuang, Zuojiang	
sco, Name for	Zhuang, Zuojiang	
sel, Name for	Zhuang, Zuojiang	
sga, Inverted name for	Zhuang, Zuojiang	
sga, Name for	Zhuang, Zuojiang	
sgg, Name for	Zhuang, Zuojiang	
sgx, Name for	Zhuang, Zuojiang	
shn, Name for	Zhuang, Zuojiang	
shu, Inverted name for	Zhuang, Zuojiang	
sid, Name for	Zhuang, Zuojiang	
sin, Name for	Zhuang, Zuojiang	
skw, Inverted name for	Zhuang, Zuojiang	
skw, Name for	Zhuang, Zuojiang	
slf, Name for	Zhuang, Zuojiang	
sli, Inverted name for	Zhuang, Zuojiang	
slk, Name for	Zhuang, Zuojiang	
slv, Name for	Zhuang, Zuojiang	
smc, Name for	Zhuang, Zuojiang	
smj, Name for	Zhuang, Zuojiang	
smn, Name for	Zhuang, Zuojiang	
smo, Name for	Zhuang, Zuojiang	
smp, Name for	Zhuang, Zuojiang	
sms, Name for	Zhuang, Zuojiang	
sna, Name for	Zhuang, Zuojiang	
snd, Name for	Zhuang, Zuojiang	
snk, Name for	Zhuang, Zuojiang	
sog, Name for	Zhuang, Zuojiang	
som, Name for	Zhuang, Zuojiang	
sot, Inverted name for	Zhuang, Zuojiang	
sov, Name for	Zhuang, Zuojiang	
spa, Name for	Zhuang, Zuojiang	
spb, Name for	Zhuang, Zuojiang	
sqi, Name for	Zhuang, Zuojiang	
sqk, Name for	Zhuang, Zuojiang	
srd, Name for	Zhuang, Zuojiang	
srn, Name for	Zhuang, Zuojiang	
srp, Name for	Zhuang, Zuojiang	
srr, Name for	Zhuang, Zuojiang	
ssr, Name for	Zhuang, Zuojiang	
ssw, Name for	Zhuang, Zuojiang	
suk, Name for	Zhuang, Zuojiang	
sun, Name for	Zhuang, Zuojiang	
sus, Name for	Zhuang, Zuojiang	
sux, Name for	Zhuang, Zuojiang	
swe, Name for	Zhuang, Zuojiang	
swl, Name for	Zhuang, Zuojiang	
syc, Name for	Zhuang, Zuojiang	
syr, Name for	Zhuang, Zuojiang	
syy, Name for	Zhuang, Zuojiang	
tah, Name for	Zhuang, Zuojiang	
tak, Name for	Zhuang, Zuojiang	
tam, Name for	Zhuang, Zuojiang	
tat, Name for	Zhuang, Zuojiang	
tbw, Name for	Zhuang, Zuojiang	
tel, Name for	Zhuang, Zuojiang	
tem, Name for	Zhuang, Zuojiang	
ter, Name for	Zhuang, Zuojiang	
tet, Name for	Zhuang, Zuojiang	
tgk, Name for	Zhuang, Zuojiang	
tgl, Name for	Zhuang, Zuojiang	
tha, Name for	Zhuang, Zuojiang	
tig, Name for	Zhuang, Zuojiang	
tir, Name for	Zhuang, Zuojiang	
tiv, Name for	Zhuang, Zuojiang	
tkl, Name for	Zhuang, Zuojiang	
tli, Name for	Zhuang, Zuojiang	
tma, Name for	Zhuang, Zuojiang	
tmh, Name for	Zhuang, Zuojiang	
tmn, Name for	Zhuang, Zuojiang	
tmw, Name for	Zhuang, Zuojiang	
tog, Name for	Zhuang, Zuojiang	
toi, Name for	Zhuang, Zuojiang	
ton, Name for	Zhuang, Zuojiang	
tpi, Name for	Zhuang, Zuojiang	
trl, Inverted name for	Zhuang, Zuojiang	
trl, Name for	Zhuang, Zuojiang	
tse, Name for	Zhuang, Zuojiang	
tsi, Name for	Zhuang, Zuojiang	
tsm, Name for	Zhuang, Zuojiang	
tsn, Name for	Zhuang, Zuojiang	
tso, Name for	Zhuang, Zuojiang	
tsq, Name for	Zhuang, Zuojiang	
tss, Name for	Zhuang, Zuojiang	
ttg, Name for	Zhuang, Zuojiang	
tuk, Name for	Zhuang, Zuojiang	
tum, Name for	Zhuang, Zuojiang	
tur, Name for	Zhuang, Zuojiang	
tuv, Name for	Zhuang, Zuojiang	
tvl, Name for	Zhuang, Zuojiang	
tvu, Name for	Zhuang, Zuojiang	
tvy, Inverted name for	Zhuang, Zuojiang	
tvy, Name for	Zhuang, Zuojiang	
twe, Name for	Zhuang, Zuojiang	
twi, Name for	Zhuang, Zuojiang	
twu, Name for	Zhuang, Zuojiang	
txg, Name for	Zhuang, Zuojiang	
tyv, Name for	Zhuang, Zuojiang	
tza, Name for	Zhuang, Zuojiang	
udm, Name for	Zhuang, Zuojiang	
uga, Name for	Zhuang, Zuojiang	
ugn, Name for	Zhuang, Zuojiang	
ugy, Name for	Zhuang, Zuojiang	
uig, Name for	Zhuang, Zuojiang	
ukl, Name for	Zhuang, Zuojiang	
ukr, Name for	Zhuang, Zuojiang	
umb, Name for	Zhuang, Zuojiang	
und, Name for	Zhuang, Zuojiang	
urd, Name for	Zhuang, Zuojiang	
uvh, Name for	Zhuang, Zuojiang	
uzb, Name for	Zhuang, Zuojiang	
vai, Name for	Zhuang, Zuojiang	
ven, Name for	Zhuang, Zuojiang	
vgt, Name for	Zhuang, Zuojiang	
vie, Name for	Zhuang, Zuojiang	
vol, Name for	Zhuang, Zuojiang	
vot, Name for	Zhuang, Zuojiang	
vsi, Name for	Zhuang, Zuojiang	
vsl, Name for	Zhuang, Zuojiang	
vsv, Name for	Zhuang, Zuojiang	
waq, Name for	Zhuang, Zuojiang	
was, Name for	Zhuang, Zuojiang	
wes, Inverted name for	Zhuang, Zuojiang	
wes, Name for	Zhuang, Zuojiang	
wln, Name for	Zhuang, Zuojiang	
wly, Name for	Zhuang, Zuojiang	
wmm, Name for	Zhuang, Zuojiang	
wol, Name for	Zhuang, Zuojiang	
xbb, Inverted name for	Zhuang, Zuojiang	
xbm, Inverted name for	Zhuang, Zuojiang	
xbm, Name for	Zhuang, Zuojiang	
xcr, Name for	Zhuang, Zuojiang	
xho, Name for	Zhuang, Zuojiang	
xil, Name for	Zhuang, Zuojiang	
xki, Name for	Zhuang, Zuojiang	
xkv, Name for	Zhuang, Zuojiang	
xlc, Name for	Zhuang, Zuojiang	
xld, Name for	Zhuang, Zuojiang	
xlu, Inverted name for	Zhuang, Zuojiang	
xlu, Name for	Zhuang, Zuojiang	
xms, Name for	Zhuang, Zuojiang	
xna, Inverted name for	Zhuang, Zuojiang	
xna, Name for	Zhuang, Zuojiang	
xxb, Name for	Zhuang, Zuojiang	
xzp, Inverted name for	Zhuang, Zuojiang	
xzp, Name for	Zhuang, Zuojiang	
yao, Name for	Zhuang, Zuojiang	
yap, Name for	Zhuang, Zuojiang	
yba, Name for	Zhuang, Zuojiang	
yid, Name for	Zhuang, Zuojiang	
ymh, Name for	Zhuang, Zuojiang	
yor, Name for	Zhuang, Zuojiang	
yuc, Name for	Zhuang, Zuojiang	
zap, Name for	Zhuang, Zuojiang	
zay, Name for	Zhuang, Zuojiang	
zaz, Name for	Zhuang, Zuojiang	
zbl, Name for	Zhuang, Zuojiang	
zen, Name for	Zhuang, Zuojiang	
zgh, Name for	Zhuang, Zuojiang	
zho, Name for	Zhuang, Zuojiang	
zib, Name for	Zhuang, Zuojiang	
zmv, Name for	Zhuang, Zuojiang	
zmw, Name for	Zhuang, Zuojiang	
zmz, Name for	Zhuang, Zuojiang	
zna, Name for	Zhuang, Zuojiang	
zne, Name for	Zhuang, Zuojiang	
zng, Name for	Zhuang, Zuojiang	
znk, Name for	Zhuang, Zuojiang	
zns, Name for	Zhuang, Zuojiang	
zoc, Inverted name for	Zhuang, Zuojiang	
zoc, Name for	Zhuang, Zuojiang	
zoh, Inverted name for	Zhuang, Zuojiang	
zom, Name for	Zhuang, Zuojiang	
zoo, Inverted name for	Zhuang, Zuojiang	
zoq, Inverted name for	Zhuang, Zuojiang	
zor, Inverted name for	Zhuang, Zuojiang	
zos, Inverted name for	Zhuang, Zuojiang	
zos, Name for	Zhuang, Zuojiang	
zpa, Inverted name for	Zhuang, Zuojiang	
zpb, Inverted name for	Zhuang, Zuojiang	
zpc, Inverted name for	Zhuang, Zuojiang	
zpe, Inverted name for	Zhuang, Zuojiang	
zpf, Inverted name for	Zhuang, Zuojiang	
zpf, Name for	Zhuang, Zuojiang	
zpg, Inverted name for	Zhuang, Zuojiang	
zpg, Name for	Zhuang, Zuojiang	
zph, Inverted name for	Zhuang, Zuojiang	
zpi, Inverted name for	Zhuang, Zuojiang	
zpi, Name for	Zhuang, Zuojiang	
zpj, Inverted name for	Zhuang, Zuojiang	
zpk, Inverted name for	Zhuang, Zuojiang	
zpl, Inverted name for	Zhuang, Zuojiang	
zpm, Inverted name for	Zhuang, Zuojiang	
zpn, Inverted name for	Zhuang, Zuojiang	
zpn, Name for	Zhuang, Zuojiang	
zpo, Inverted name for	Zhuang, Zuojiang	
zpp, Inverted name for	Zhuang, Zuojiang	
zpq, Inverted name for	Zhuang, Zuojiang	
zpr, Inverted name for	Zhuang, Zuojiang	
zpr, Name for	Zhuang, Zuojiang	
zps, Inverted name for	Zhuang, Zuojiang	
zpt, Inverted name for	Zhuang, Zuojiang	
zpt, Name for	Zhuang, Zuojiang	
zpu, Inverted name for	Zhuang, Zuojiang	
zpv, Inverted name for	Zhuang, Zuojiang	
zpw, Inverted name for	Zhuang, Zuojiang	
zpx, Inverted name for	Zhuang, Zuojiang	
zpx, Name for	Zhuang, Zuojiang	
zpy, Inverted name for	Zhuang, Zuojiang	
zpz, Inverted name for	Zhuang, Zuojiang	
zqe, Inverted name for	Zhuang, Zuojiang	
zra, Name for	Zhuang, Zuojiang	
zrg, Name for	Zhuang, Zuojiang	
zrn, Name for	Zhuang, Zuojiang	
zro, Name for	Zhuang, Zuojiang	
zrp, Name for	Zhuang, Zuojiang	
zrs, Name for	Zhuang, Zuojiang	
zsa, Name for	Zhuang, Zuojiang	
zsk, Name for	Zhuang, Zuojiang	
zsl, Name for	Zhuang, Zuojiang	
zsm, Inverted name for	Zhuang, Zuojiang	
zsu, Name for	Zhuang, Zuojiang	
zte, Inverted name for	Zhuang, Zuojiang	
ztg, Inverted name for	Zhuang, Zuojiang	
ztl, Inverted name for	Zhuang, Zuojiang	
ztl, Name for	Zhuang, Zuojiang	
ztm, Inverted name for	Zhuang, Zuojiang	
ztm, Name for	Zhuang, Zuojiang	
ztn, Inverted name for	Zhuang, Zuojiang	
ztn, Name for	Zhuang, Zuojiang	
ztp, Inverted name for	Zhuang, Zuojiang	
ztp, Name for	Zhuang, Zuojiang	
ztq, Inverted name for	Zhuang, Zuojiang	
ztq, Name for	Zhuang, Zuojiang	
zts, Inverted name for	Zhuang, Zuojiang	
ztt, Inverted name for	Zhuang, Zuojiang	
ztu, Inverted name for	Zhuang, Zuojiang	
ztu, Name for	Zhuang, Zuojiang	
ztx, Inverted name for	Zhuang, Zuojiang	
ztx, Name for	Zhuang, Zuojiang	
zty, Inverted name for	Zhuang, Zuojiang	
zty, Name for	Zhuang, Zuojiang	
zua, Name for	Zhuang, Zuojiang	
zuh, Name for	Zhuang, Zuojiang	
zul, Name for	Zhuang, Zuojiang	
zum, Name for	Zhuang, Zuojiang	
zun, Name for	Zhuang, Zuojiang	
zuy, Name for	Zhuang, Zuojiang	
zwa, Name for	Zhuang, Zuojiang	
zxx, Name for	Zhuang, Zuojiang	
zyb, Inverted name for	Zhuang, Zuojiang	
zyb, Name for	Zhuang, Zuojiang	
zyg, Inverted name for	Zhuang, Zuojiang	
zyg, Name for	Zhuang, Zuojiang	
zyj, Inverted name for	Zhuang, Zuojiang	
zyj, Name for	Zhuang, Zuojiang	
zyn, Inverted name for	Zhuang, Zuojiang	
zyn, Name for	Zhuang, Zuojiang	
zza, Name for	Zhuang, Zuojiang	
zzj, Inverted name for	Zhuang, Zuojiang	
zzj, Name for	Zhuang, Zuojiang	
