Code	Engels	Nederlands
AD-02, Name for	Canillo	Canillo
AD-03, Name for	Encamp	Encamp
AD-04, Name for	La Massana	La Massana
AD-05, Name for	Ordino	Ordino
AD-06, Name for	Sant Julià de Lòria	Sant Julià de Lòria
AD-07, Name for	Andorra la Vella	Andorra la Vella
AD-08, Name for	Escaldes-Engordany	Escaldes-Engordany
AE-AJ, Name for	‘Ajmān	Ajman
AE-AZ, Name for	Abū Z̧aby	Abu Dhabi
AE-DU, Name for	Dubayy	Dubai
AE-FU, Name for	Al Fujayrah	Fujairah
AE-RK, Name for	Ra’s al Khaymah	Ras al-Khaimah
AE-SH, Name for	Ash Shāriqah	Sharjah
AE-UQ, Name for	Umm al Qaywayn	Umm al-Qawain
AF-BAL, Name for	Balkh	Balkh
AF-BAM, Name for	Bāmyān	Bamyan
AF-BDG, Name for	Bādghīs	Badghis
AF-BDS, Name for	Badakhshān	Badakhshan
AF-BGL, Name for	Baghlān	Baghlan
AF-DAY, Name for	Dāykundī	Daikondi
AF-FRA, Name for	Farāh	Farah
AF-FYB, Name for	Fāryāb	Faryab
AF-GHA, Name for	Ghaznī	Ghazni
AF-GHO, Name for	Ghōr	Ghowr
AF-HEL, Name for	Helmand	Helmand
AF-HER, Name for	Herāt	Herat
AF-JOW, Name for	Jowzjān	Jowzjan
AF-KAB, Name for	Kābul	Kabul
AF-KAN, Name for	Kandahār	Kandahar
AF-KAP, Name for	Kāpīsā	Kapisa
AF-KDZ, Name for	Kunduz	Kunduz
AF-KHO, Name for	Khōst	Khost
AF-KNR, Name for	Kunaṟ	Kunar
AF-LAG, Name for	Laghmān	Laghman
AF-LOG, Name for	Lōgar	Logar
AF-NAN, Name for	Nangarhār	Nangarhar
AF-NIM, Name for	Nīmrōz	Nimroz
AF-NUR, Name for	Nūristān	Nooristan
AF-PAN, Name for	Panjshayr	Panjshir
AF-PAR, Name for	Parwān	Parwan
AF-PIA, Name for	Paktiyā	Paktia
AF-PKA, Name for	Paktīkā	Paktika
AF-SAM, Name for	Samangān	Samangan
AF-SAR, Name for	Sar-e Pul	Sar-e Pol
AF-TAK, Name for	Takhār	Takhār
AF-URU, Name for	Uruzgān	Uruzgan
AF-WAR, Name for	Wardak	Wardak
AF-ZAB, Name for	Zābul	Zabul
AG-03, Name for	Saint George	Saint George
AG-04, Name for	Saint John	Saint John
AG-05, Name for	Saint Mary	Saint Mary
AG-06, Name for	Saint Paul	Saint Paul
AG-07, Name for	Saint Peter	Saint Peter
AG-08, Name for	Saint Philip	Saint Philip
AG-10, Name for	Barbuda	Barbuda
AG-11, Name for	Redonda	Redonda
AL-01, Name for	Berat	Berat
AL-02, Name for	Durrës	Durrsës
AL-03, Name for	Elbasan	Elbasan
AL-04, Name for	Fier	Fier
AL-05, Name for	Gjirokastër	Gjirokastër
AL-06, Name for	Korçë	Korçë
AL-07, Name for	Kukës	Kukës
AL-08, Name for	Lezhë	Lezhë
AL-09, Name for	Dibër	Dibër
AL-10, Name for	Shkodër	Shkodër
AL-11, Name for	Tiranë	Tirana
AL-12, Name for	Vlorë	Vlorë
AM-AG, Name for	Aragac̣otn	Aragacotn
AM-AR, Name for	Ararat	Ararat
AM-AV, Name for	Armavir	Armavir
AM-ER, Name for	Erevan	Jerevan
AM-GR, Name for	Geġark'unik'	Gegark'unik'
AM-KT, Name for	Kotayk'	Kotayk'
AM-LO, Name for	Loṙi	Lori
AM-SH, Name for	Širak	Sirak
AM-SU, Name for	Syunik'	Syunik'
AM-TV, Name for	Tavuš	Tavus
AM-VD, Name for	Vayoć Jor	Vayoc Jor
AO-BGO, Name for	Bengo	Bengo
AO-BGU, Name for	Benguela	Benguela
AO-BIE, Name for	Bié	Bié
AO-CAB, Name for	Cabinda	Cabinda
AO-CCU, Name for	Cuando Cubango	Cuando-Cubango
AO-CNN, Name for	Cunene	Cunene
AO-CNO, Name for	Cuanza-Norte	Noord-Cuanza
AO-CUS, Name for	Cuanza-Sul	Zuid-Cuanza
AO-HUA, Name for	Huambo	Huambo
AO-HUI, Name for	Huíla	Huíla
AO-LNO, Name for	Lunda-Norte	Noord-Lunda
AO-LSU, Name for	Lunda-Sul	Zuid-Lunda
AO-LUA, Name for	Luanda	Luanda
AO-MAL, Name for	Malange	Malange
AO-MOX, Name for	Moxico	Moxico
AO-NAM, Name for	Namibe	Namibe
AO-UIG, Name for	Uíge	Uíge
AO-ZAI, Name for	Zaire	Zaïre
AR-A, Name for	Salta	Salta
AR-B, Name for	Buenos Aires	Buenos Aires
AR-C, Name for	Ciudad Autónoma de Buenos Aires	Autonome Stad Buenos Aires
AR-D, Name for	San Luis	San Luis
AR-E, Name for	Entre Ríos	Entre Ríos
AR-F, Name for	La Rioja	La Rioja
AR-G, Name for	Santiago del Estero	Santiago del Estero
AR-H, Name for	Chaco	Chaco
AR-J, Name for	San Juan	San Juan
AR-K, Name for	Catamarca	Catamarca
AR-L, Name for	La Pampa	La Pampa
AR-M, Name for	Mendoza	Mendoza
AR-N, Name for	Misiones	Misiones
AR-P, Name for	Formosa	Formosa
AR-Q, Name for	Neuquén	Neuquén
AR-R, Name for	Río Negro	Río Negro
AR-S, Name for	Santa Fe	Santa Fe
AR-T, Name for	Tucumán	Tucumán
AR-U, Name for	Chubut	Chubut
AR-V, Name for	Tierra del Fuego	Tierra del Fuego
AR-W, Name for	Corrientes	Corrientes
AR-X, Name for	Córdoba	Córdoba
AR-Y, Name for	Jujuy	Jujuy
AR-Z, Name for	Santa Cruz	Santa Cruz
AT-1, Name for	Burgenland	Burgenland
AT-2, Name for	Kärnten	Karinthië
AT-3, Name for	Niederösterreich	Neder-Oostenrijk
AT-4, Name for	Oberösterreich	Opper-Oostenrijk
AT-5, Name for	Salzburg	Salzburg
AT-6, Name for	Steiermark	Steiermark
AT-7, Name for	Tirol	Tirol
AT-8, Name for	Vorarlberg	Vorarlberg
AT-9, Name for	Wien	Wenen
AU-ACT, Name for	Australian Capital Territory	Australisch Hoofdstedelijk Territorium
AU-NSW, Name for	New South Wales	Nieuw-Zuid-Wales
AU-NT, Name for	Northern Territory	Noordelijk Territorium
AU-QLD, Name for	Queensland	Queensland
AU-SA, Name for	South Australia	Zuid-Australië
AU-TAS, Name for	Tasmania	Tasmanië
AU-VIC, Name for	Victoria	Victoria
AU-WA, Name for	Western Australia	West-Australië
AZ-ABS, Name for	Abşeron	Abseron
AZ-AGA, Name for	Ağstafa	Agstafa
AZ-AGC, Name for	Ağcabədi	Agcabadi
AZ-AGM, Name for	Ağdam	Agdam
AZ-AGS, Name for	Ağdaş	Agdas
AZ-AGU, Name for	Ağsu	Agsu
AZ-AST, Name for	Astara	Astara
AZ-BA, Name for	Bakı	Bakoe
AZ-BAB, Name for	Babək	Babak
AZ-BAL, Name for	Balakən	Balakan
AZ-BAR, Name for	Bərdə	Barda
AZ-BEY, Name for	Beyləqan	Beylaqan
AZ-BIL, Name for	Biləsuvar	Bilasuvar
AZ-CAB, Name for	Cəbrayıl	Cabrayil
AZ-CAL, Name for	Cəlilabad	Cəlilabad
AZ-CUL, Name for	Culfa	Culfa
AZ-DAS, Name for	Daşkəsən	Daskasan
AZ-FUZ, Name for	Füzuli	Fuzuli
AZ-GA, Name for	Gəncə	Ganca
AZ-GAD, Name for	Gədəbəy	Gadabay
AZ-GOR, Name for	Goranboy	Goranboy
AZ-GOY, Name for	Göyçay	Goycay
AZ-GYG, Name for	Göygöl	Göygöl
AZ-HAC, Name for	Hacıqabul	Haciqabul
AZ-IMI, Name for	İmişli	Imisli
AZ-ISM, Name for	İsmayıllı	Ismayilli
AZ-KAL, Name for	Kəlbəcər	Kalbacar
AZ-KAN, Name for	Kǝngǝrli	Kangarli
AZ-KUR, Name for	Kürdəmir	Kurdamir
AZ-LA, Name for	Lənkəran	Lankaran
AZ-LAC, Name for	Laçın	Lacin
AZ-LAN, Name for	Lənkəran	Lankaran
AZ-LER, Name for	Lerik	Lerik
AZ-MAS, Name for	Masallı	Masalli
AZ-MI, Name for	Mingəçevir	Mingacevir
AZ-NA, Name for	Naftalan	Naftalan
AZ-NEF, Name for	Neftçala	Neftcala
AZ-NV, Name for	Naxçıvan	Nachitsjevan
AZ-NX, Name for	Naxçıvan	Nachitsjevan
AZ-OGU, Name for	Oğuz	Oguz
AZ-ORD, Name for	Ordubad	Ordubad
AZ-QAB, Name for	Qəbələ	Qabala
AZ-QAX, Name for	Qax	Qax
AZ-QAZ, Name for	Qazax	Qazax
AZ-QBA, Name for	Quba	Quba
AZ-QBI, Name for	Qubadlı	Qubadli
AZ-QOB, Name for	Qobustan	Qobustan
AZ-QUS, Name for	Qusar	Qusar
AZ-SA, Name for	Şəki	Saki
AZ-SAB, Name for	Sabirabad	Sabirabad
AZ-SAD, Name for	Sədərək	Sadarak
AZ-SAH, Name for	Şahbuz	Sahbuz
AZ-SAK, Name for	Şəki	Saki
AZ-SAL, Name for	Salyan	Salyan
AZ-SAR, Name for	Şərur	Sarur
AZ-SAT, Name for	Saatlı	Saatli
AZ-SBN, Name for	Şabran	Şabran
AZ-SIY, Name for	Siyəzən	Siyazan
AZ-SKR, Name for	Şəmkir	Samkir
AZ-SM, Name for	Sumqayıt	Sumqayit
AZ-SMI, Name for	Şamaxı	Samaxi
AZ-SMX, Name for	Samux	Samux
AZ-SR, Name for	Şirvan	Şirvan
AZ-SUS, Name for	Şuşa	Susa
AZ-TAR, Name for	Tərtər	Tartar
AZ-TOV, Name for	Tovuz	Tovuz
AZ-UCA, Name for	Ucar	Ucar
AZ-XA, Name for	Xankəndi	Xankandi
AZ-XAC, Name for	Xaçmaz	Xacmaz
AZ-XCI, Name for	Xocalı	Xocali
AZ-XIZ, Name for	Xızı	Xizi
AZ-XVD, Name for	Xocavənd	Xocavand
AZ-YAR, Name for	Yardımlı	Yardimli
AZ-YE, Name for	Yevlax	Yevlax
AZ-YEV, Name for	Yevlax	Yevlax
AZ-ZAN, Name for	Zəngilan	Zangilan
AZ-ZAQ, Name for	Zaqatala	Zaqatala
AZ-ZAR, Name for	Zərdab	Zardab
BA-BIH, Name for	Federacija Bosne i Hercegovine	Bosnië-Herzegovina, Federatie
BA-BRC, Name for	Brčko distrikt	Brcko-district
BA-SRP, Name for	Republika Srpska	Servië, Republiek
BB-01, Name for	Christ Church	Christ Church
BB-02, Name for	Saint Andrew	Saint Andrew
BB-03, Name for	Saint George	Saint George
BB-04, Name for	Saint James	Saint James
BB-05, Name for	Saint John	Saint John
BB-06, Name for	Saint Joseph	Saint Joseph
BB-07, Name for	Saint Lucy	Saint Lucy
BB-08, Name for	Saint Michael	Saint Michael
BB-09, Name for	Saint Peter	Saint Peter
BB-10, Name for	Saint Philip	Saint Philip
BB-11, Name for	Saint Thomas	Saint Thomas
BD-01, Name for	Bandarban	Bandarban
BD-02, Name for	Barguna	Barguna
BD-03, Name for	Bogura	Bogura
BD-04, Name for	Brahmanbaria	Brahmanbaria
BD-05, Name for	Bagerhat	Bagerhat
BD-06, Name for	Barishal	Barisal
BD-07, Name for	Bhola	Bhola
BD-08, Name for	Cumilla	Comilla
BD-09, Name for	Chandpur	Chandpur
BD-10, Name for	Chattogram	Chittagong
BD-11, Name for	Cox's Bazar	Cox's Bazar
BD-12, Name for	Chuadanga	Chuadanga
BD-13, Name for	Dhaka	Dhaka
BD-14, Name for	Dinajpur	Dinajpur
BD-15, Name for	Faridpur	Faridpur
BD-16, Name for	Feni	Feni
BD-17, Name for	Gopalganj	Gopalganj
BD-18, Name for	Gazipur	Gazipur
BD-19, Name for	Gaibandha	Gaibandha
BD-20, Name for	Habiganj	Habiganj
BD-21, Name for	Jamalpur	Jamalpur
BD-22, Name for	Jashore	Jessore
BD-23, Name for	Jhenaidah	Jhenaidah
BD-24, Name for	Joypurhat	Jaipurhat
BD-25, Name for	Jhalakathi	Jhalokati
BD-26, Name for	Kishoreganj	Kishoreganj
BD-27, Name for	Khulna	Khulna
BD-28, Name for	Kurigram	Kurigram
BD-29, Name for	Khagrachhari	Khagrachari
BD-30, Name for	Kushtia	Kushtia
BD-31, Name for	Lakshmipur	Lakshmipur
BD-32, Name for	Lalmonirhat	Lalmonirhat
BD-33, Name for	Manikganj	Manikganj
BD-34, Name for	Mymensingh	Mymensingh
BD-35, Name for	Munshiganj	Munshiganj
BD-36, Name for	Madaripur	Madaripur
BD-37, Name for	Magura	Magura
BD-38, Name for	Moulvibazar	Moulvibazar
BD-39, Name for	Meherpur	Meherpur
BD-40, Name for	Narayanganj	Narayanganj
BD-41, Name for	Netrakona	Netrakona
BD-42, Name for	Narsingdi	Narsingdi
BD-43, Name for	Narail	Narail
BD-44, Name for	Natore	Natore
BD-45, Name for	Chapai Nawabganj	Chapai Nawabganj
BD-46, Name for	Nilphamari	Nilphamari
BD-47, Name for	Noakhali	Noakhali
BD-48, Name for	Naogaon	Naogaon
BD-49, Name for	Pabna	Pabna
BD-50, Name for	Pirojpur	Pirojpur
BD-51, Name for	Patuakhali	Patuakhali
BD-52, Name for	Panchagarh	Panchagarh
BD-53, Name for	Rajbari	Rajbari
BD-54, Name for	Rajshahi	Rajshahi
BD-55, Name for	Rangpur	Rangpur
BD-56, Name for	Rangamati	Rangamati
BD-57, Name for	Sherpur	Sherpur
BD-58, Name for	Satkhira	Satkhira
BD-59, Name for	Sirajganj	Sirajganj
BD-60, Name for	Sylhet	Sylhet
BD-61, Name for	Sunamganj	Sunamganj
BD-62, Name for	Shariatpur	Shariatpur
BD-63, Name for	Tangail	Tangail
BD-64, Name for	Thakurgaon	Thakurgaon
BD-A, Name for	Barishal	Barisal
BD-B, Name for	Chattogram	Chittagong
BD-C, Name for	Dhaka	Dhaka
BD-D, Name for	Khulna	Khulna
BD-E, Name for	Rajshahi	Rajshahi
BD-F, Name for	Rangpur	Rangpur
BD-G, Name for	Sylhet	Sylhet
BD-H, Name for	Mymensingh	Mymensingh
BE-BRU, Name for	Brussels Hoofdstedelijk Gewest	Brussels Hoofdstedelijk Gewest
BE-VAN, Name for	Antwerpen	Antwerpen
BE-VBR, Name for	Vlaams-Brabant	Vlaams-Brabant
BE-VLG, Name for	Vlaams Gewest	Vlaams Gewest
BE-VLI, Name for	Limburg	Limburg
BE-VOV, Name for	Oost-Vlaanderen	Oost-Vlaanderen
BE-VWV, Name for	West-Vlaanderen	West-Vlaanderen
BE-WAL, Name for	wallonne, Région	Wallonië, Gewest
BE-WBR, Name for	Brabant wallon	Waals-Brabant
BE-WHT, Name for	Hainaut	Henegouwen
BE-WLG, Name for	Liège	Luik
BE-WLX, Name for	Luxembourg	Luxemburg
BE-WNA, Name for	Namur	Namen
BF-01, Name for	Boucle du Mouhoun	Boucle du Mouhoun
BF-02, Name for	Cascades	Cascades
BF-03, Name for	Centre	Centre
BF-04, Name for	Centre-Est	Centre-Est
BF-05, Name for	Centre-Nord	Centre-Nord
BF-06, Name for	Centre-Ouest	Centre-Ouest
BF-07, Name for	Centre-Sud	Centre-Sud
BF-08, Name for	Est	Est
BF-09, Name for	Hauts-Bassins	Hauts-Bassins
BF-10, Name for	Nord	Noord
BF-11, Name for	Plateau-Central	Plateau-Central
BF-12, Name for	Sahel	Sahel
BF-13, Name for	Sud-Ouest	Sud-Ouest
BF-BAL, Name for	Balé	Balé
BF-BAM, Name for	Bam	Bam
BF-BAN, Name for	Banwa	Banwa
BF-BAZ, Name for	Bazèga	Bazéga
BF-BGR, Name for	Bougouriba	Bougouriba
BF-BLG, Name for	Boulgou	Boulgou
BF-BLK, Name for	Boulkiemdé	Boulkiemdé
BF-COM, Name for	Comoé	Comoé
BF-GAN, Name for	Ganzourgou	Ganzourgou
BF-GNA, Name for	Gnagna	Gnagna
BF-GOU, Name for	Gourma	Gourma
BF-HOU, Name for	Houet	Houet
BF-IOB, Name for	Ioba	Ioba
BF-KAD, Name for	Kadiogo	Kadiogo
BF-KEN, Name for	Kénédougou	Kénédougou
BF-KMD, Name for	Komondjari	Komondjari
BF-KMP, Name for	Kompienga	Kompienga
BF-KOP, Name for	Koulpélogo	Koulpélogo
BF-KOS, Name for	Kossi	Kossi
BF-KOT, Name for	Kouritenga	Kouritenga
BF-KOW, Name for	Kourwéogo	Kourwéogo
BF-LER, Name for	Léraba	Léraba
BF-LOR, Name for	Loroum	Loroum
BF-MOU, Name for	Mouhoun	Mouhoun
BF-NAM, Name for	Namentenga	Namentenga
BF-NAO, Name for	Nahouri	Nahouri
BF-NAY, Name for	Nayala	Nayala
BF-NOU, Name for	Noumbiel	Noumbiel
BF-OUB, Name for	Oubritenga	Oubritenga
BF-OUD, Name for	Oudalan	Oudalan
BF-PAS, Name for	Passoré	Passoré
BF-PON, Name for	Poni	Poni
BF-SEN, Name for	Séno	Séno
BF-SIS, Name for	Sissili	Sissili
BF-SMT, Name for	Sanmatenga	Sanmatenga
BF-SNG, Name for	Sanguié	Sanguié
BF-SOM, Name for	Soum	Soum
BF-SOR, Name for	Sourou	Sourou
BF-TAP, Name for	Tapoa	Tapoa
BF-TUI, Name for	Tuy	Tuy
BF-YAG, Name for	Yagha	Yagha
BF-YAT, Name for	Yatenga	Yatenga
BF-ZIR, Name for	Ziro	Ziro
BF-ZON, Name for	Zondoma	Zondoma
BF-ZOU, Name for	Zoundwéogo	Zoundwéogo
BG-01, Name for	Blagoevgrad	Blagoëvgrad
BG-02, Name for	Burgas	Boergas
BG-03, Name for	Varna	Varna
BG-04, Name for	Veliko Tarnovo	Veliko Tarnovo
BG-05, Name for	Vidin	Vidin
BG-06, Name for	Vratsa	Vratsa
BG-07, Name for	Gabrovo	Gabrovo
BG-08, Name for	Dobrich	Dobritsj
BG-09, Name for	Kardzhali	Kardzjali
BG-10, Name for	Kyustendil	Kjoestendil
BG-11, Name for	Lovech	Lovetsj
BG-12, Name for	Montana	Montana
BG-13, Name for	Pazardzhik	Pazardzjik
BG-14, Name for	Pernik	Pernik
BG-15, Name for	Pleven	Pleven
BG-16, Name for	Plovdiv	Plovdiv
BG-17, Name for	Razgrad	Razgrad
BG-18, Name for	Ruse	Roese
BG-19, Name for	Silistra	Silistra
BG-20, Name for	Sliven	Sliven
BG-21, Name for	Smolyan	Smoljan
BG-22, Name for	Sofia (stolitsa)	Sofia-Hoofdstad
BG-23, Name for	Sofia	Sofia
BG-24, Name for	Stara Zagora	Stara Zagora
BG-25, Name for	Targovishte	Targovisjte
BG-26, Name for	Haskovo	Chaskovo
BG-27, Name for	Shumen	Sjoemen
BG-28, Name for	Yambol	Jambol
BH-13, Name for	Al ‘Āşimah	Al-Asimah
BH-14, Name for	Al Janūbīyah	Al Janblyah
BH-15, Name for	Al Muḩarraq	Al Muharraq
BH-17, Name for	Ash Shamālīyah	Ash Shamallyah
BI-BB, Name for	Bubanza	Bubanza
BI-BL, Name for	Bujumbura Rural	Bujumbura Rural
BI-BM, Name for	Bujumbura Mairie	Bujumbura Mairie
BI-BR, Name for	Bururi	Bururi
BI-CA, Name for	Cankuzo	Cankuzo
BI-CI, Name for	Cibitoke	Cibitoke
BI-GI, Name for	Gitega	Gitega
BI-KI, Name for	Kirundo	Kirundo
BI-KR, Name for	Karuzi	Karuzi
BI-KY, Name for	Kayanza	Kayanza
BI-MA, Name for	Makamba	Makamba
BI-MU, Name for	Muramvya	Muramvya
BI-MW, Name for	Mwaro	Mwaro
BI-MY, Name for	Muyinga	Muyinga
BI-NG, Name for	Ngozi	Ngozi
BI-RM, Name for	Rumonge	Rumonge
BI-RT, Name for	Rutana	Rutana
BI-RY, Name for	Ruyigi	Ruyigi
BJ-AK, Name for	Atacora	Atacora
BJ-AL, Name for	Alibori	Alibori
BJ-AQ, Name for	Atlantique	Atlantique
BJ-BO, Name for	Borgou	Borgou
BJ-CO, Name for	Collines	Collines
BJ-DO, Name for	Donga	Donga
BJ-KO, Name for	Couffo	Couffo
BJ-LI, Name for	Littoral	Littoral
BJ-MO, Name for	Mono	Mono
BJ-OU, Name for	Ouémé	Ouémé
BJ-PL, Name for	Plateau	Plateau
BJ-ZO, Name for	Zou	Zou
BN-BE, Name for	Belait	Belait
BN-BM, Name for	Brunei-Muara	Brunei en Muara
BN-TE, Name for	Temburong	Temburong
BN-TU, Name for	Tutong	Tutong
BO-B, Name for	El Beni	El Beni
BO-C, Name for	Cochabamba	Cochabamba
BO-H, Name for	Chuquisaca	Chuquisaca
BO-L, Name for	La Paz	La Paz
BO-N, Name for	Pando	Pando
BO-O, Name for	Oruro	Oruro
BO-P, Name for	Potosí	Potosí
BO-S, Name for	Santa Cruz	Santa Cruz
BO-T, Name for	Tarija	Tarija
BQ-BO, Name for	Bonaire	Bonaire
BQ-SA, Name for	Saba	Saba
BQ-SE, Name for	Sint Eustatius	Sint Eustatius
BR-AC, Name for	Acre	Acre
BR-AL, Name for	Alagoas	Alagoas
BR-AM, Name for	Amazonas	Amazonas
BR-AP, Name for	Amapá	Amapá
BR-BA, Name for	Bahia	Bahia
BR-CE, Name for	Ceará	Ceará
BR-DF, Name for	Distrito Federal	Federaal District
BR-ES, Name for	Espírito Santo	Espírito Santo
BR-GO, Name for	Goiás	Goiás
BR-MA, Name for	Maranhão	Maranhão
BR-MG, Name for	Minas Gerais	Minas Gerais
BR-MS, Name for	Mato Grosso do Sul	Zuidelijk Mato Grosso
BR-MT, Name for	Mato Grosso	Mato Grosso
BR-PA, Name for	Pará	Pará
BR-PB, Name for	Paraíba	Paraíba
BR-PE, Name for	Pernambuco	Pernambuco
BR-PI, Name for	Piauí	Piauí
BR-PR, Name for	Paraná	Paraná
BR-RJ, Name for	Rio de Janeiro	Rio de Janeiro
BR-RN, Name for	Rio Grande do Norte	Rio Grande do Norte
BR-RO, Name for	Rondônia	Rondônia
BR-RR, Name for	Roraima	Roraima
BR-RS, Name for	Rio Grande do Sul	Rio Grande do Sul
BR-SC, Name for	Santa Catarina	Santa Catarina
BR-SE, Name for	Sergipe	Sergipe
BR-SP, Name for	São Paulo	São Paulo
BR-TO, Name for	Tocantins	Tocantins
BS-AK, Name for	Acklins	Acklins
BS-BI, Name for	Bimini	Bimini
BS-BP, Name for	Black Point	Black Point
BS-BY, Name for	Berry Islands	Berry-eilanden
BS-CE, Name for	Central Eleuthera	Central Eleuthera
BS-CI, Name for	Cat Island	Cat Island
BS-CK, Name for	Crooked Island and Long Cay	Crooked Island en Long Cay
BS-CO, Name for	Central Abaco	Central Abaco
BS-CS, Name for	Central Andros	Central Andros
BS-EG, Name for	East Grand Bahama	East Grand Bahama
BS-EX, Name for	Exuma	Exuma
BS-FP, Name for	City of Freeport	Freeport (stad)
BS-GC, Name for	Grand Cay	Grand Cay
BS-HI, Name for	Harbour Island	Harbour Island
BS-HT, Name for	Hope Town	Hope Town
BS-IN, Name for	Inagua	Inagua
BS-LI, Name for	Long Island	Long Island
BS-MC, Name for	Mangrove Cay	Mangrove Cay
BS-MG, Name for	Mayaguana	Mayaguana
BS-MI, Name for	Moore's Island	Moore's Island
BS-NE, Name for	North Eleuthera	North Eleuthera
BS-NO, Name for	North Abaco	North Abaco
BS-NP, Name for	New Providence	New Providence
BS-NS, Name for	North Andros	North Andros
BS-RC, Name for	Rum Cay	Rum Cay
BS-RI, Name for	Ragged Island	Ragged Island
BS-SA, Name for	South Andros	South Andros
BS-SE, Name for	South Eleuthera	South Eleuthera
BS-SO, Name for	South Abaco	South Abaco
BS-SS, Name for	San Salvador	San Salvador
BS-SW, Name for	Spanish Wells	Spanish Wells
BS-WG, Name for	West Grand Bahama	West Grand Bahama
BT-11, Name for	Paro	Paro
BT-12, Name for	Chhukha	Chhukha
BT-13, Name for	Haa	Haa
BT-14, Name for	Samtse	Samtse
BT-15, Name for	Thimphu	Thimphu
BT-21, Name for	Tsirang	Tsirang
BT-22, Name for	Dagana	Dagana
BT-23, Name for	Punakha	Punakha
BT-24, Name for	Wangdue Phodrang	Wangdue Phodrang
BT-31, Name for	Sarpang	Sarpang
BT-32, Name for	Trongsa	Trongsa
BT-33, Name for	Bumthang	Bumthang
BT-34, Name for	Zhemgang	Zhemgang
BT-41, Name for	Trashigang	Trashigang
BT-42, Name for	Monggar	Monggar
BT-43, Name for	Pema Gatshel	Pemagatshel
BT-44, Name for	Lhuentse	Lhuentse
BT-45, Name for	Samdrup Jongkhar	Samdrup Jongkhar
BT-GA, Name for	Gasa	Gasa
BT-TY, Name for	Trashi Yangtse	Trashi Yangtse
BW-CE, Name for	Central	Central
BW-CH, Name for	Chobe	Chobe
BW-FR, Name for	Francistown	Francistown
BW-GA, Name for	Gaborone	Gaborone
BW-GH, Name for	Ghanzi	Ghanzi
BW-JW, Name for	Jwaneng	Jwaneng
BW-KG, Name for	Kgalagadi	Kgalagadi
BW-KL, Name for	Kgatleng	Kgatleng
BW-KW, Name for	Kweneng	Kweneng
BW-LO, Name for	Lobatse	Lobatse
BW-NE, Name for	North East	Noord-Oost
BW-NW, Name for	North West	Noord-West
BW-SE, Name for	South East	Zuid-Oost
BW-SO, Name for	Southern	Zuid
BW-SP, Name for	Selibe Phikwe	Selibe Phikwe
BW-ST, Name for	Sowa Town	Sowa Town
BY-BR, Name for	Bresckaja voblasć	Brest, Provincie
BY-HM, Name for	Gorod Minsk	Minsk (stad)
BY-HO, Name for	Gomel'skaja oblast'	Homel, Provincie
BY-HR, Name for	Grodnenskaja oblast'	Grodno, Provincie
BY-MA, Name for	Mahilioŭskaja voblasć	Mahiljow, Provincie
BY-MI, Name for	Minskaja oblast'	Minsk, Oblast
BY-VI, Name for	Viciebskaja voblasć	Vitebsk, Provincie
BZ-BZ, Name for	Belize	Belize
BZ-CY, Name for	Cayo	Cayo
BZ-CZL, Name for	Corozal	Corozal
BZ-OW, Name for	Orange Walk	Orange Walk
BZ-SC, Name for	Stann Creek	Stann Creek
BZ-TOL, Name for	Toledo	Toledo
CA-AB, Name for	Alberta	Alberta
CA-BC, Name for	British Columbia	Brits-Columbia
CA-MB, Name for	Manitoba	Manitoba
CA-NB, Name for	New Brunswick	New Brunswick
CA-NL, Name for	Newfoundland and Labrador	Newfoundland en Labrador
CA-NS, Name for	Nova Scotia	Nova Scotia
CA-NT, Name for	Northwest Territories	Noord-West Territoria
CA-NU, Name for	Nunavut	Nunavut
CA-ON, Name for	Ontario	Ontario
CA-PE, Name for	Prince Edward Island	Prins Edwardeiland
CA-QC, Name for	Quebec	Quebec
CA-SK, Name for	Saskatchewan	Saskatchewan
CA-YT, Name for	Yukon	Yukon
CD-BC, Name for	Kongo Central	Kongo Central
CD-BU, Name for	Bas-Uélé	Bas-Uele
CD-EQ, Name for	Équateur	Evenaarsprovincie
CD-HK, Name for	Haut-Katanga	Haut-Katanga
CD-HL, Name for	Haut-Lomami	Hoog-Loire
CD-HU, Name for	Haut-Uélé	Hoog-Pyreneeën
CD-IT, Name for	Ituri	Asturië
CD-KC, Name for	Kasaï Central	Mashonaland Centraal
CD-KE, Name for	Kasaï Oriental	Oost-Kasaï
CD-KG, Name for	Kwango	Yangon
CD-KL, Name for	Kwilu	Kwilu
CD-KN, Name for	Kinshasa	Kinshasa
CD-KS, Name for	Kasaï	Kasaï
CD-LO, Name for	Lomami	Lomami
CD-LU, Name for	Lualaba	Dalaba
CD-MA, Name for	Maniema	Maniema
CD-MN, Name for	Mai-Ndombe	Mai-Ndombe
CD-MO, Name for	Mongala	Monggar
CD-NK, Name for	Nord-Kivu	Noord-Kivu
CD-NU, Name for	Nord-Ubangi	Noord-Ubangi
CD-SA, Name for	Sankuru	Nakuru
CD-SK, Name for	Sud-Kivu	Zuid-Kivu
CD-SU, Name for	Sud-Ubangi	Zuid-Ubangi
CD-TA, Name for	Tanganyika	Telangana
CD-TO, Name for	Tshopo	Tshopo
CD-TU, Name for	Tshuapa	Tshuapa
CF-AC, Name for	Ouham	Ouham
CF-BB, Name for	Bamingui-Bangoran	Bamingui-Bangoran
CF-BGF, Name for	Bangui	Bangui
CF-BK, Name for	Basse-Kotto	Basse-Kotto
CF-HK, Name for	Haute-Kotto	Haute-Kotto
CF-HM, Name for	Haut-Mbomou	Haut-Mbomou
CF-HS, Name for	Haute-Sangha / Mambéré-Kadéï	Mambéré-Kadéï
CF-KB, Name for	Gribingui	Gribingui
CF-KG, Name for	Kemö-Gïrïbïngï	Kémo
CF-LB, Name for	Lobaye	Lobaye
CF-MB, Name for	Mbomou	Mbomou
CF-MP, Name for	Ombella-Mpoko	Ombella-Mpoko
CF-NM, Name for	Nana-Mambéré	Nana-Mambéré
CF-OP, Name for	Ouham-Pendé	Ouham-Pendé
CF-SE, Name for	Sangha	Sangha
CF-UK, Name for	Ouaka	Ouaka
CF-VK, Name for	Vakaga	Vakaga
CG-11, Name for	Bouenza	Bouenza
CG-12, Name for	Pool	Pool
CG-13, Name for	Sangha	Sangha
CG-14, Name for	Plateaux	Plateaux
CG-15, Name for	Cuvette-Ouest	Cuvette-West
CG-16, Name for	Pointe-Noire	Pointe-Noire
CG-2, Name for	Lékoumou	Lékoumou
CG-5, Name for	Kouilou	Kouilou
CG-7, Name for	Likouala	Likouala
CG-8, Name for	Cuvette	Cuvette
CG-9, Name for	Niari	Niari
CG-BZV, Name for	Brazzaville	Brazzaville
CH-AG, Name for	Aargau	Aargau
CH-AI, Name for	Appenzell Innerrhoden	Appenzell Innerrhoden
CH-AR, Name for	Appenzell Ausserrhoden	Appenzell Ausserrhoden
CH-BE, Name for	Bern	Bern
CH-BL, Name for	Basel-Landschaft	Bazel-Landschap
CH-BS, Name for	Basel-Stadt	Basel-Stad
CH-FR, Name for	Freiburg	Fribourg
CH-GE, Name for	Genève	Genève
CH-GL, Name for	Glarus	Glarus
CH-GR, Name for	Graubünden	Graubünden
CH-JU, Name for	Jura	Jura
CH-LU, Name for	Luzern	Luzern
CH-NE, Name for	Neuchâtel	Neuchâtel
CH-NW, Name for	Nidwalden	Nidwalden
CH-OW, Name for	Obwalden	Obwalden
CH-SG, Name for	Sankt Gallen	Sankt Gallen
CH-SH, Name for	Schaffhausen	Schaffhausen
CH-SO, Name for	Solothurn	Solothurn
CH-SZ, Name for	Schwyz	Schwyz
CH-TG, Name for	Thurgau	Thurgau
CH-TI, Name for	Ticino	Ticino
CH-UR, Name for	Uri	Uri
CH-VD, Name for	Vaud	Vaud
CH-VS, Name for	Valais	Valais
CH-ZG, Name for	Zug	Zug
CH-ZH, Name for	Zürich	Zürich
CI-AB, Name for	Abidjan	Abidjan
CI-BS, Name for	Bas-Sassandra	Bas-Sassandra
CI-CM, Name for	Comoé	Comoé
CI-DN, Name for	Denguélé	Denguélé
CI-GD, Name for	Gôh-Djiboua	Gôh-Djiboua
CI-LC, Name for	Lacs	Lacs
CI-LG, Name for	Lagunes	Lagunes
CI-MG, Name for	Montagnes	Montagnes
CI-SM, Name for	Sassandra-Marahoué	Sassandra-Marahoué
CI-SV, Name for	Savanes	Savanes
CI-VB, Name for	Vallée du Bandama	Vallée du Bandama
CI-WR, Name for	Woroba	Worobe
CI-YM, Name for	Yamoussoukro	Yamoussoukro
CI-ZZ, Name for	Zanzan	Zanzan
CL-AI, Name for	Aisén del General Carlos Ibañez del Campo	Aysén del General Carlos Ibáñez del Campo
CL-AN, Name for	Antofagasta	Antofagasta
CL-AP, Name for	Arica y Parinacota	Arica y Parinacota
CL-AR, Name for	La Araucanía	La Araucanía
CL-AT, Name for	Atacama	Atacama
CL-BI, Name for	Biobío	Biobío
CL-CO, Name for	Coquimbo	Coquimbo
CL-LI, Name for	Libertador General Bernardo O'Higgins	Bevrijder Generaal Bernard O'Higgins
CL-LL, Name for	Los Lagos	Los Lagos
CL-LR, Name for	Los Ríos	Los Ríos
CL-MA, Name for	Magallanes	Magallanes
CL-ML, Name for	Maule	Maule
CL-NB, Name for	Ñuble	Ñuble
CL-RM, Name for	Región Metropolitana de Santiago	Santiago, Hoofdstedelijke Regio van
CL-TA, Name for	Tarapacá	Tarapacá
CL-VS, Name for	Valparaíso	Valparaíso
CM-AD, Name for	Adamaoua	Adamaoua
CM-CE, Name for	Centre	Centre
CM-EN, Name for	Far North	Verre Noorden
CM-ES, Name for	East	Oost
CM-LT, Name for	Littoral	Littoral
CM-NO, Name for	North	Noord
CM-NW, Name for	North-West	Noord-West
CM-OU, Name for	West	West
CM-SU, Name for	South	Zuid
CM-SW, Name for	South-West	Zuid-West
CN-AH, Name for	Anhui Sheng	Anhui, Provincie
CN-BJ, Name for	Beijing Shi	Peking, Stadsprovincie; Beijing, Stadsprovincie
CN-CQ, Name for	Chongqing Shi	Tsjoengking, Stadsprovincie; Chongqing, Stadsprovincie
CN-FJ, Name for	Fujian Sheng	Fujian, Provincie
CN-GD, Name for	Guangdong Sheng	Guangdong, Provincie
CN-GS, Name for	Gansu Sheng	Gansu, Provincie
CN-GX, Name for	Guangxi Zhuangzu Zizhiqu	Guangxi Zhuang Autonome Regio
CN-GZ, Name for	Guizhou Sheng	Guizhou, Provincie
CN-HA, Name for	Henan Sheng	Henan, Provincie
CN-HB, Name for	Hubei Sheng	Hubei, Provincie
CN-HE, Name for	Hebei Sheng	Hebei, Provincie
CN-HI, Name for	Hainan Sheng	Hainan, Provincie
CN-HK, Name for	Hong Kong SAR	Hongkong (speciale bestuurlijke regio)
CN-HL, Name for	Heilongjiang Sheng	Heilongjiang, Provincie
CN-HN, Name for	Hunan Sheng	Hunan, Provincie
CN-JL, Name for	Jilin Sheng	Jilin, Provincie
CN-JS, Name for	Jiangsu Sheng	Jiangsu, Provincie
CN-JX, Name for	Jiangxi Sheng	Jiangxi, Provincie
CN-LN, Name for	Liaoning Sheng	Liaoning, Provincie
CN-MO, Name for	Macao SAR	Macau (speciale bestuurlijke regio)
CN-NM, Name for	Nei Mongol Zizhiqu	Binnen-Mongolië, Autonome Regio
CN-NX, Name for	Ningxia Huizi Zizhiqu	Autonome Hui Regio Ningxia
CN-QH, Name for	Qinghai Sheng	Qinghai, Provincie
CN-SC, Name for	Sichuan Sheng	Sichuan, Provincie
CN-SD, Name for	Shandong Sheng	Shandong, Provincie
CN-SH, Name for	Shanghai Shi	Sjanghai, Stadsprovincie
CN-SN, Name for	Shaanxi Sheng	Shaanxi, Provincie
CN-SX, Name for	Shanxi Sheng	Shanxi, Provincie
CN-TJ, Name for	Tianjin Shi	Tianjin, Stadsprovincie
CN-TW, Name for	Taiwan Sheng	Hainan, Provincie
CN-XJ, Name for	Xinjiang Uygur Zizhiqu	Xinjiang, Autonome Oeigoerse Regio
CN-XZ, Name for	Xizang Zizhiqu	Tibetaanse Autonome Regio
CN-YN, Name for	Yunnan Sheng	Yunnan, Provincie
CN-ZJ, Name for	Zhejiang Sheng	Zhejiang, Provincie
CO-AMA, Name for	Amazonas	Amazonas
CO-ANT, Name for	Antioquia	Antioquia
CO-ARA, Name for	Arauca	Arauca
CO-ATL, Name for	Atlántico	Atlántico
CO-BOL, Name for	Bolívar	Bolívar
CO-BOY, Name for	Boyacá	Boyacá
CO-CAL, Name for	Caldas	Caldas
CO-CAQ, Name for	Caquetá	Caquetá
CO-CAS, Name for	Casanare	Casanare
CO-CAU, Name for	Cauca	Cauca
CO-CES, Name for	Cesar	Cesar
CO-CHO, Name for	Chocó	Chocó
CO-COR, Name for	Córdoba	Córdoba
CO-CUN, Name for	Cundinamarca	Cundinamarca
CO-DC, Name for	Distrito Capital de Bogotá	Bogotá, Hoofdstedelijk Gewest van
CO-GUA, Name for	Guainía	Guainía
CO-GUV, Name for	Guaviare	Guaviare
CO-HUI, Name for	Huila	Huila
CO-LAG, Name for	La Guajira	La Guajira
CO-MAG, Name for	Magdalena	Magdalena
CO-MET, Name for	Meta	Meta
CO-NAR, Name for	Nariño	Nariño
CO-NSA, Name for	Norte de Santander	Noordelijk van Santander
CO-PUT, Name for	Putumayo	Putumayo
CO-QUI, Name for	Quindío	Quindío
CO-RIS, Name for	Risaralda	Risaralda
CO-SAN, Name for	Santander	Santander
CO-SAP, Name for	San Andrés, Providencia y Santa Catalina	San Andrés, Providencia en Santa Catalina
CO-SUC, Name for	Sucre	Sucre
CO-TOL, Name for	Tolima	Tolima
CO-VAC, Name for	Valle del Cauca	Vallei van de Cauca
CO-VAU, Name for	Vaupés	Vaupés
CO-VID, Name for	Vichada	Vichada
CR-A, Name for	Alajuela	Alajuela
CR-C, Name for	Cartago	Cartago
CR-G, Name for	Guanacaste	Guanacaste
CR-H, Name for	Heredia	Heredia
CR-L, Name for	Limón	Limón
CR-P, Name for	Puntarenas	Puntarenas
CR-SJ, Name for	San José	San José
CU-01, Name for	Pinar del Río	Pinar del Río
CU-03, Name for	La Habana	La Habana
CU-04, Name for	Matanzas	Matanzas
CU-05, Name for	Villa Clara	Villa Clara
CU-06, Name for	Cienfuegos	Cienfuegos
CU-07, Name for	Sancti Spíritus	Sancti Spíritus
CU-08, Name for	Ciego de Ávila	Ciego de Ávila
CU-09, Name for	Camagüey	Camagüey
CU-10, Name for	Las Tunas	Las Tunas
CU-11, Name for	Holguín	Holguín
CU-12, Name for	Granma	Granma
CU-13, Name for	Santiago de Cuba	Santiago de Cuba
CU-14, Name for	Guantánamo	Guantánamo
CU-15, Name for	Artemisa	Artemisa
CU-16, Name for	Mayabeque	Mayabeque
CU-99, Name for	Isla de la Juventud	Isla de la Juventud
CV-B, Name for	Ilhas de Barlavento	Ilhas de Barlavento
CV-BR, Name for	Brava	Brava
CV-BV, Name for	Boa Vista	Boa Vista
CV-CA, Name for	Santa Catarina	Santa Catarina
CV-CF, Name for	Santa Catarina do Fogo	Santa Catarina do Fogo
CV-CR, Name for	Santa Cruz	Santa Cruz
CV-MA, Name for	Maio	Maio
CV-MO, Name for	Mosteiros	Mosteiros
CV-PA, Name for	Paul	Paul
CV-PN, Name for	Porto Novo	Porto Novo
CV-PR, Name for	Praia	Praia
CV-RB, Name for	Ribeira Brava	Ribeira Brava
CV-RG, Name for	Ribeira Grande	Ribeira Grande
CV-RS, Name for	Ribeira Grande de Santiago	Ribeira Grande de Santiago
CV-S, Name for	Ilhas de Sotavento	Ilhas de Sotavento
CV-SD, Name for	São Domingos	São Domingos
CV-SF, Name for	São Filipe	São Filipe
CV-SL, Name for	Sal	Sal
CV-SM, Name for	São Miguel	São Miguel
CV-SO, Name for	São Lourenço dos Órgãos	São Lourenço dos Órgãos
CV-SS, Name for	São Salvador do Mundo	São Salvador do Mundo
CV-SV, Name for	São Vicente	São Vicente
CV-TA, Name for	Tarrafal	Tarrafal
CV-TS, Name for	Tarrafal de São Nicolau	Tarrafal de São Nicolau
CY-01, Name for	Lefkosia	Nicosia
CY-02, Name for	Lemesos	Limasol
CY-03, Name for	Larnaka	Larnaca
CY-04, Name for	Ammochostos	Famagusta
CY-05, Name for	Baf	Paphos; Pafos
CY-06, Name for	Girne	Girne
CZ-10, Name for	Praha, Hlavní město	Praag, Hoofdstedelijk Gewest
CZ-20, Name for	Středočeský kraj	Midden-Bohemen, Regio
CZ-201, Name for	Benešov	Benešov
CZ-202, Name for	Beroun	Beroun
CZ-203, Name for	Kladno	Kladno
CZ-204, Name for	Kolín	Kolín
CZ-205, Name for	Kutná Hora	Kutná Hora
CZ-206, Name for	Mělník	Mělník
CZ-207, Name for	Mladá Boleslav	Mladá Boleslav
CZ-208, Name for	Nymburk	Nymburk
CZ-209, Name for	Praha-východ	Praag-Oost
CZ-20A, Name for	Praha-západ	Praag-West
CZ-20B, Name for	Příbram	Příbram
CZ-20C, Name for	Rakovník	Rakovník
CZ-31, Name for	Jihočeský kraj	Zuid-Bohemen, Regio
CZ-311, Name for	České Budějovice	České Budějovice
CZ-312, Name for	Český Krumlov	Český Krumlov
CZ-313, Name for	Jindřichův Hradec	Jindřichův Hradec
CZ-314, Name for	Písek	Písek
CZ-315, Name for	Prachatice	Prachatice
CZ-316, Name for	Strakonice	Strakonice
CZ-317, Name for	Tábor	Tábor
CZ-32, Name for	Plzeňský kraj	Pilsen, Regio
CZ-321, Name for	Domažlice	Domažlice
CZ-322, Name for	Klatovy	Klatovy
CZ-323, Name for	Plzeň-město	Pilsen-Stad
CZ-324, Name for	Plzeň-jih	Pilsen-Zuid
CZ-325, Name for	Plzeň-sever	Pilsen-Noord
CZ-326, Name for	Rokycany	Rokycany
CZ-327, Name for	Tachov	Tachov
CZ-41, Name for	Karlovarský kraj	Karlsbad, Regio
CZ-411, Name for	Cheb	Cheb
CZ-412, Name for	Karlovy Vary	Karlsbad
CZ-413, Name for	Sokolov	Sokolov
CZ-42, Name for	Ústecký kraj	Ústí nad Labem, Regio
CZ-421, Name for	Děčín	Děčín
CZ-422, Name for	Chomutov	Chomutov
CZ-423, Name for	Litoměřice	Litoměřice
CZ-424, Name for	Louny	Louny
CZ-425, Name for	Most	Most
CZ-426, Name for	Teplice	Teplice
CZ-427, Name for	Ústí nad Labem	Ústí nad Labem
CZ-51, Name for	Liberecký kraj	Liberec, Regio
CZ-511, Name for	Česká Lípa	Česká Lípa
CZ-512, Name for	Jablonec nad Nisou	Jablonec nad Nisou
CZ-513, Name for	Liberec	Liberec
CZ-514, Name for	Semily	Semily
CZ-52, Name for	Královéhradecký kraj	Hradec Králové, Regio
CZ-521, Name for	Hradec Králové	Hradec Králové
CZ-522, Name for	Jičín	Jičín
CZ-523, Name for	Náchod	Náchod
CZ-524, Name for	Rychnov nad Kněžnou	Rychnov nad Kněžnou
CZ-525, Name for	Trutnov	Trutnov
CZ-53, Name for	Pardubický kraj	Pardubice, Regio
CZ-531, Name for	Chrudim	Chrudim
CZ-532, Name for	Pardubice	Pardubice
CZ-533, Name for	Svitavy	Svitavy
CZ-534, Name for	Ústí nad Orlicí	Ústí nad Orlicí
CZ-63, Name for	Kraj Vysočina	Vysočina, Regio
CZ-631, Name for	Havlíčkův Brod	Havlíčkův Brod
CZ-632, Name for	Jihlava	Jihlava
CZ-633, Name for	Pelhřimov	Pelhřimov
CZ-634, Name for	Třebíč	Třebíč
CZ-635, Name for	Žďár nad Sázavou	Žďár nad Sázavou
CZ-64, Name for	Jihomoravský kraj	Zuid-Moravië, Regio
CZ-641, Name for	Blansko	Blansko
CZ-642, Name for	Brno-město	Brno-město
CZ-643, Name for	Brno-venkov	Brno-venkov
CZ-644, Name for	Břeclav	Břeclav
CZ-645, Name for	Hodonín	Hodonín
CZ-646, Name for	Vyškov	Vyškov
CZ-647, Name for	Znojmo	Znojmo
CZ-71, Name for	Olomoucký kraj	Olomouc, Regio
CZ-711, Name for	Jeseník	Jeseník
CZ-712, Name for	Olomouc	Olomouc
CZ-713, Name for	Prostějov	Prostějov
CZ-714, Name for	Přerov	Přerov
CZ-715, Name for	Šumperk	Šumperk
CZ-72, Name for	Zlínský kraj	Zlín, Regio
CZ-721, Name for	Kroměříž	Kroměříž
CZ-722, Name for	Uherské Hradiště	Uherské Hradiště
CZ-723, Name for	Vsetín	Vsetín
CZ-724, Name for	Zlín	Zlín
CZ-80, Name for	Moravskoslezský kraj	Moravisch-Silezië, Regio
CZ-801, Name for	Bruntál	Bruntál
CZ-802, Name for	Frýdek-Místek	Frýdek-Místek
CZ-803, Name for	Karviná	Karviná
CZ-804, Name for	Nový Jičín	Nový Jičín
CZ-805, Name for	Opava	Opava
CZ-806, Name for	Ostrava-město	Ostrava-město
DE-BB, Name for	Brandenburg	Brandenburg
DE-BE, Name for	Berlin	Berlijn
DE-BW, Name for	Baden-Württemberg	Baden-Württemberg
DE-BY, Name for	Bayern	Beieren
DE-HB, Name for	Bremen	Bremen
DE-HE, Name for	Hessen	Hessen
DE-HH, Name for	Hamburg	Hamburg
DE-MV, Name for	Mecklenburg-Vorpommern	Mecklenburg-Vorpommern
DE-NI, Name for	Niedersachsen	Nedersaksen
DE-NW, Name for	Nordrhein-Westfalen	Nordrhein-Westfalen
DE-RP, Name for	Rheinland-Pfalz	Rheinland-Pfalz
DE-SH, Name for	Schleswig-Holstein	Schleswig-Holstein
DE-SL, Name for	Saarland	Saarland
DE-SN, Name for	Sachsen	Saksen
DE-ST, Name for	Sachsen-Anhalt	Sachsen-Anhalt
DE-TH, Name for	Thüringen	Thüringen
DJ-AR, Name for	Arta	Arta
DJ-AS, Name for	Ali Sabieh	Ali Sabieh
DJ-DI, Name for	Dikhil	Dikhil
DJ-DJ, Name for	Djibouti	Djibouti
DJ-OB, Name for	Awbūk	Awbuk
DJ-TA, Name for	Tadjourah	Tadjourah
DK-81, Name for	Nordjylland	Noord-Jutland
DK-82, Name for	Midtjylland	Midden-Jutland
DK-83, Name for	Syddanmark	Zuid-Denemarken
DK-84, Name for	Hovedstaden	Hoofdstad
DK-85, Name for	Sjælland	Seeland
DM-02, Name for	Saint Andrew	Saint Andrew
DM-03, Name for	Saint David	Saint David
DM-04, Name for	Saint George	Saint George
DM-05, Name for	Saint John	Saint John
DM-06, Name for	Saint Joseph	Saint Joseph
DM-07, Name for	Saint Luke	Saint Luke
DM-08, Name for	Saint Mark	Saint Mark
DM-09, Name for	Saint Patrick	Saint Patrick
DM-10, Name for	Saint Paul	Saint Paul
DM-11, Name for	Saint Peter	Saint Peter
DO-01, Name for	Distrito Nacional (Santo Domingo)	Distrito Nacional (Santo Domingo de Guzmán)
DO-02, Name for	Azua	Azua
DO-03, Name for	Baoruco	Baoruco
DO-04, Name for	Barahona	Barahona
DO-05, Name for	Dajabón	Dajabón
DO-06, Name for	Duarte	Duarte
DO-07, Name for	Elías Piña	Elías Piña
DO-08, Name for	El Seibo	El Seibo
DO-09, Name for	Espaillat	Espaillat
DO-10, Name for	Independencia	Independencia
DO-11, Name for	La Altagracia	La Altagracia
DO-12, Name for	La Romana	La Romana
DO-13, Name for	La Vega	La Vega
DO-14, Name for	María Trinidad Sánchez	María Trinidad Sánchez
DO-15, Name for	Monte Cristi	Monte Cristi
DO-16, Name for	Pedernales	Pedernales
DO-17, Name for	Peravia	Peravia
DO-18, Name for	Puerto Plata	Puerto Plata
DO-19, Name for	Hermanas Mirabal	Hermanas Mirabal
DO-20, Name for	Samaná	Samaná
DO-21, Name for	San Cristóbal	San Cristóbal
DO-22, Name for	San Juan	San Juan
DO-23, Name for	San Pedro de Macorís	San Pedro de Macorís
DO-24, Name for	Sánchez Ramírez	Sánchez Ramírez
DO-25, Name for	Santiago	Santiago
DO-26, Name for	Santiago Rodríguez	Santiago Rodríguez
DO-27, Name for	Valverde	Valverde
DO-28, Name for	Monseñor Nouel	Monseñor Nouel
DO-29, Name for	Monte Plata	Monte Plata
DO-30, Name for	Hato Mayor	Hato Mayor
DO-31, Name for	San José de Ocoa	San José de Ocoa
DO-32, Name for	Santo Domingo	Santo Domingo
DO-33, Name for	Cibao Nordeste	Cibao Nordeste (III)
DO-34, Name for	Cibao Noroeste	Cibao Noroeste (IV)
DO-35, Name for	Cibao Norte	Bioko Norte (I)
DO-36, Name for	Cibao Sur	Cibao Sur (II)
DO-37, Name for	El Valle	El Valle
DO-38, Name for	Enriquillo	Enriquillo
DO-39, Name for	Higuamo	Higüamo
DO-40, Name for	Ozama	Ozama
DO-41, Name for	Valdesia	Valdesia
DO-42, Name for	Yuma	Yuma
DZ-01, Name for	Adrar	Adrar
DZ-02, Name for	Chlef	Chlef
DZ-03, Name for	Laghouat	Laghouat
DZ-04, Name for	Oum el Bouaghi	Oum el Bouaghi
DZ-05, Name for	Batna	Batna
DZ-06, Name for	Béjaïa	Béjaïa
DZ-07, Name for	Biskra	Biskra
DZ-08, Name for	Béchar	Béchar
DZ-09, Name for	Blida	Blida
DZ-10, Name for	Bouira	Bouira
DZ-11, Name for	Tamanrasset	Tamanrasset
DZ-12, Name for	Tébessa	Tébessa
DZ-13, Name for	Tlemcen	Tlemcen
DZ-14, Name for	Tiaret	Tiaret
DZ-15, Name for	Tizi Ouzou	Tizi Ouzou
DZ-16, Name for	Alger	Algiers
DZ-17, Name for	Djelfa	Djelfa
DZ-18, Name for	Jijel	Jijel
DZ-19, Name for	Sétif	Sétif
DZ-20, Name for	Saïda	Saida
DZ-21, Name for	Skikda	Skikda
DZ-22, Name for	Sidi Bel Abbès	Sidi-bel-Abbes
DZ-23, Name for	Annaba	Annaba
DZ-24, Name for	Guelma	Guelma
DZ-25, Name for	Constantine	Constantine
DZ-26, Name for	Médéa	Médéa
DZ-27, Name for	Mostaganem	Mostaganem
DZ-28, Name for	M'sila	M'sila
DZ-29, Name for	Mascara	Mascara
DZ-30, Name for	Ouargla	Ouargla
DZ-31, Name for	Oran	Oran
DZ-32, Name for	El Bayadh	El Bayadh
DZ-33, Name for	Illizi	Illizi
DZ-34, Name for	Bordj Bou Arréridj	Bordj Bou Arréridj
DZ-35, Name for	Boumerdès	Boumerdès
DZ-36, Name for	El Tarf	El Tarf
DZ-37, Name for	Tindouf	Tindouf
DZ-38, Name for	Tissemsilt	Tissemsilt
DZ-39, Name for	El Oued	El Oued
DZ-40, Name for	Khenchela	Khenchela
DZ-41, Name for	Souk Ahras	Souk Ahras
DZ-42, Name for	Tipaza	Tipaza
DZ-43, Name for	Mila	Mila
DZ-44, Name for	Aïn Defla	Aïn Defla
DZ-45, Name for	Naama	Naama
DZ-46, Name for	Aïn Témouchent	Aïn Témouchent
DZ-47, Name for	Ghardaïa	Ghardaïa
DZ-48, Name for	Relizane	Relizane
EC-A, Name for	Azuay	Azuay
EC-B, Name for	Bolívar	Bolívar
EC-C, Name for	Carchi	Carchi
EC-D, Name for	Orellana	Orellana
EC-E, Name for	Esmeraldas	Esmeraldas
EC-F, Name for	Cañar	Cañar
EC-G, Name for	Guayas	Guayas
EC-H, Name for	Chimborazo	Chimborazo
EC-I, Name for	Imbabura	Imbabura
EC-L, Name for	Loja	Loja
EC-M, Name for	Manabí	Manabí
EC-N, Name for	Napo	Napo
EC-O, Name for	El Oro	El Oro
EC-P, Name for	Pichincha	Pichincha
EC-R, Name for	Los Ríos	Los Ríos
EC-S, Name for	Morona Santiago	Morona-Santiago
EC-SD, Name for	Santo Domingo de los Tsáchilas	Santo Domingo de los Tsáchilas
EC-SE, Name for	Santa Elena	Santa Elena
EC-T, Name for	Tungurahua	Tungurahua
EC-U, Name for	Sucumbíos	Sucumbíos
EC-W, Name for	Galápagos	Galápagos
EC-X, Name for	Cotopaxi	Cotopaxi
EC-Y, Name for	Pastaza	Pastaza
EC-Z, Name for	Zamora Chinchipe	Zamora-Chinchipe
EE-130, Name for	Alutaguse	NOG NIET VERTAALD
EE-141, Name for	Anija	NOG NIET VERTAALD
EE-142, Name for	Antsla	NOG NIET VERTAALD
EE-171, Name for	Elva	NOG NIET VERTAALD
EE-184, Name for	Haapsalu	NOG NIET VERTAALD
EE-191, Name for	Haljala	NOG NIET VERTAALD
EE-198, Name for	Harku	NOG NIET VERTAALD
EE-205, Name for	Hiiumaa	Hiiumaa
EE-214, Name for	Häädemeeste	NOG NIET VERTAALD
EE-245, Name for	Jõelähtme	NOG NIET VERTAALD
EE-247, Name for	Jõgeva	Jõgevamaa
EE-251, Name for	Jõhvi	NOG NIET VERTAALD
EE-255, Name for	Järva	Järvamaa
EE-272, Name for	Kadrina	Barinas
EE-283, Name for	Kambja	NOG NIET VERTAALD
EE-284, Name for	Kanepi	NOG NIET VERTAALD
EE-291, Name for	Kastre	Kastoria
EE-293, Name for	Kehtna	NOG NIET VERTAALD
EE-296, Name for	Keila	NOG NIET VERTAALD
EE-303, Name for	Kihnu	NOG NIET VERTAALD
EE-305, Name for	Kiili	NOG NIET VERTAALD
EE-317, Name for	Kohila	NOG NIET VERTAALD
EE-321, Name for	Kohtla-Järve	NOG NIET VERTAALD
EE-338, Name for	Kose	NOG NIET VERTAALD
EE-353, Name for	Kuusalu	NOG NIET VERTAALD
EE-37, Name for	Harjumaa	Harjumaa
EE-39, Name for	Hiiumaa	Hiiumaa
EE-424, Name for	Loksa	NOG NIET VERTAALD
EE-430, Name for	Lääneranna	Läänemaa
EE-431, Name for	Lääne-Harju	Lääne-Virumaa
EE-432, Name for	Luunja	Punjab
EE-441, Name for	Lääne-Nigula	Lääne-Virumaa
EE-442, Name for	Lüganuse	NOG NIET VERTAALD
EE-446, Name for	Maardu	NOG NIET VERTAALD
EE-45, Name for	Ida-Virumaa	Ida-Virumaa
EE-478, Name for	Muhu	NOG NIET VERTAALD
EE-480, Name for	Mulgi	NOG NIET VERTAALD
EE-486, Name for	Mustvee	NOG NIET VERTAALD
EE-50, Name for	Jõgevamaa	Jõgevamaa
EE-503, Name for	Märjamaa	Järvamaa
EE-511, Name for	Narva	NOG NIET VERTAALD
EE-514, Name for	Narva-Jõesuu	NOG NIET VERTAALD
EE-52, Name for	Järvamaa	Järvamaa
EE-528, Name for	Nõo	NOG NIET VERTAALD
EE-557, Name for	Otepää	NOG NIET VERTAALD
EE-56, Name for	Läänemaa	Läänemaa
EE-567, Name for	Paide	NOG NIET VERTAALD
EE-586, Name for	Peipsiääre	NOG NIET VERTAALD
EE-60, Name for	Lääne-Virumaa	Lääne-Virumaa
EE-615, Name for	Põhja-Sakala	NOG NIET VERTAALD
EE-618, Name for	Põltsamaa	Põlvamaa
EE-622, Name for	Põlva	Põlvamaa
EE-624, Name for	Pärnu	Pärnumaa
EE-638, Name for	Põhja-Pärnumaa	Pärnumaa
EE-64, Name for	Põlvamaa	Põlvamaa
EE-651, Name for	Raasiku	NOG NIET VERTAALD
EE-653, Name for	Rae	Lae
EE-661, Name for	Rakvere	NOG NIET VERTAALD
EE-663, Name for	Rakvere	NOG NIET VERTAALD
EE-668, Name for	Rapla	Raplamaa
EE-68, Name for	Pärnumaa	Pärnumaa
EE-689, Name for	Ruhnu	NOG NIET VERTAALD
EE-698, Name for	Rõuge	NOG NIET VERTAALD
EE-708, Name for	Räpina	NOG NIET VERTAALD
EE-71, Name for	Raplamaa	Raplamaa
EE-712, Name for	Saarde	Saarland
EE-714, Name for	Saaremaa	Saaremaa
EE-719, Name for	Saku	NOG NIET VERTAALD
EE-726, Name for	Saue	NOG NIET VERTAALD
EE-732, Name for	Setomaa	NOG NIET VERTAALD
EE-735, Name for	Sillamäe	Sillamäe
EE-74, Name for	Saaremaa	Saaremaa
EE-784, Name for	Tallinn	NOG NIET VERTAALD
EE-79, Name for	Tartumaa	Tartumaa
EE-792, Name for	Tapa	NOG NIET VERTAALD
EE-793, Name for	Tartu	Tartus
EE-796, Name for	Tartu	Tartus
EE-803, Name for	Toila	NOG NIET VERTAALD
EE-809, Name for	Tori	Turijn
EE-81, Name for	Valgamaa	Valgamaa
EE-824, Name for	Tõrva	NOG NIET VERTAALD
EE-834, Name for	Türi	NOG NIET VERTAALD
EE-84, Name for	Viljandimaa	Viljandimaa
EE-855, Name for	Valga	Valgamaa
EE-87, Name for	Võrumaa	Võrumaa
EE-890, Name for	Viimsi	NOG NIET VERTAALD
EE-897, Name for	Viljandi	Viljandimaa
EE-899, Name for	Viljandi	Viljandimaa
EE-901, Name for	Vinni	NOG NIET VERTAALD
EE-903, Name for	Viru-Nigula	NOG NIET VERTAALD
EE-907, Name for	Vormsi	NOG NIET VERTAALD
EE-917, Name for	Võru	Võrumaa
EE-919, Name for	Võru	Võrumaa
EE-928, Name for	Väike-Maarja	NOG NIET VERTAALD
EG-ALX, Name for	Al Iskandarīyah	Alexandrië
EG-ASN, Name for	Aswān	Aswan
EG-AST, Name for	Asyūţ	Assioet
EG-BA, Name for	Al Baḩr al Aḩmar	Al-Bahr-al-Ahmar
EG-BH, Name for	Al Buḩayrah	Al Buhayrah
EG-BNS, Name for	Banī Suwayf	Beni Suef
EG-C, Name for	Al Qāhirah	Caïro
EG-DK, Name for	Ad Daqahlīyah	Ad Daqahlyah
EG-DT, Name for	Dumyāţ	Dimyat
EG-FYM, Name for	Al Fayyūm	Al Fajoem
EG-GH, Name for	Al Gharbīyah	Al Gharbiyah
EG-GZ, Name for	Al Jīzah	Gizeh
EG-IS, Name for	Al Ismā'īlīyah	Ismaïlia
EG-JS, Name for	Janūb Sīnā'	Zuidelijke Sinaï
EG-KB, Name for	Al Qalyūbīyah	Al Qalyubiyah
EG-KFS, Name for	Kafr ash Shaykh	Kafr ash Shaykh
EG-KN, Name for	Qinā	Qina
EG-LX, Name for	Al Uqşur	Luxor
EG-MN, Name for	Al Minyā	Minya
EG-MNF, Name for	Al Minūfīyah	Al Minufiyah
EG-MT, Name for	Maţrūḩ	Matruh
EG-PTS, Name for	Būr Sa‘īd	Port Said
EG-SHG, Name for	Sūhāj	Suhaj
EG-SHR, Name for	Ash Sharqīyah	Ash Sharqiyah
EG-SIN, Name for	Shamāl Sīnā'	Noordelijke Sinaï
EG-SUZ, Name for	As Suways	As Suways
EG-WAD, Name for	Al Wādī al Jadīd	Al Wadi al Jadid
ER-AN, Name for	Ansabā	Anseba
ER-DK, Name for	Debubawi K’eyyĭḥ Baḥri	Debubawi Keyih Bahri
ER-DU, Name for	Al Janūbī	Debub
ER-GB, Name for	Gash-Barka	Gash-Barka
ER-MA, Name for	Al Awsaţ	Maekel
ER-SK, Name for	Semienawi K’eyyĭḥ Baḥri	Semenawi Keyih Bahri
ES-A, Name for	Alacant*	Alicante
ES-AB, Name for	Albacete	Albacete
ES-AL, Name for	Almería	Almería
ES-AN, Name for	Andalucía	Andalusië
ES-AR, Name for	Aragón	Aragón
ES-AS, Name for	Asturias, Principado de	Asturië, Vorstendom
ES-AV, Name for	Ávila	Ávila
ES-B, Name for	Barcelona [Barcelona]	Barcelona
ES-BA, Name for	Badajoz	Badajoz
ES-BI, Name for	Bizkaia	Bizkaia
ES-BU, Name for	Burgos	Burgos
ES-C, Name for	A Coruña [La Coruña]	A Coruña
ES-CA, Name for	Cádiz	Cádiz
ES-CB, Name for	Cantabria	Cantabrië
ES-CC, Name for	Cáceres	Cáceres
ES-CE, Name for	Ceuta	Ceuta
ES-CL, Name for	Castilla y León	Castilla y León
ES-CM, Name for	Castilla-La Mancha	Castilla-La Mancha
ES-CN, Name for	Canarias	Canarische Eilanden
ES-CO, Name for	Córdoba	Córdoba
ES-CR, Name for	Ciudad Real	Ciudad Real
ES-CS, Name for	Castelló*	Castellón
ES-CT, Name for	Catalunya [Cataluña]	Catalonië
ES-CU, Name for	Cuenca	Cuenca
ES-EX, Name for	Extremadura	Extremadura
ES-GA, Name for	Galicia [Galicia]	Galicia
ES-GC, Name for	Las Palmas	Las Palmas
ES-GI, Name for	Girona [Gerona]	Gerona
ES-GR, Name for	Granada	Granada
ES-GU, Name for	Guadalajara	Guadalajara
ES-H, Name for	Huelva	Huelva
ES-HU, Name for	Huesca	Huesca
ES-IB, Name for	Illes Balears [Islas Baleares]	Balearen
ES-J, Name for	Jaén	Jaén
ES-L, Name for	Lleida [Lérida]	Lerida
ES-LE, Name for	León	León
ES-LO, Name for	La Rioja	La Rioja
ES-LU, Name for	Lugo [Lugo]	Lugo
ES-M, Name for	Madrid	Madrid
ES-MA, Name for	Málaga	Málaga
ES-MC, Name for	Murcia, Región de	Murcia, Regio
ES-MD, Name for	Madrid, Comunidad de	Madrid, Gemeenschap
ES-ML, Name for	Melilla	Melilla
ES-MU, Name for	Murcia	Murcia
ES-NA, Name for	Nafarroa*	Navarra
ES-NC, Name for	Nafarroako Foru Komunitatea*	Navarra, Forale Gemeenschap
ES-O, Name for	Asturias	Asturië
ES-OR, Name for	Ourense [Orense]	Ourense
ES-P, Name for	Palencia	Palencia
ES-PM, Name for	Illes Balears [Islas Baleares]	Balearen
ES-PO, Name for	Pontevedra [Pontevedra]	Pontevedra
ES-PV, Name for	Euskal Herria	Baskenland
ES-RI, Name for	La Rioja	La Rioja
ES-S, Name for	Cantabria	Cantabrië
ES-SA, Name for	Salamanca	Salamanca
ES-SE, Name for	Sevilla	Sevilla
ES-SG, Name for	Segovia	Segovia
ES-SO, Name for	Soria	Soria
ES-SS, Name for	Gipuzkoa	Gipuzkoa
ES-T, Name for	Tarragona [Tarragona]	Tarragona
ES-TE, Name for	Teruel	Teruel
ES-TF, Name for	Santa Cruz de Tenerife	Santa Cruz de Tenerife
ES-TO, Name for	Toledo	Toledo
ES-V, Name for	Valencia	Valencia
ES-VA, Name for	Valladolid	Valladolid
ES-VC, Name for	Valenciana, Comunidad	Valencia, Autonome Gemeenschap
ES-VI, Name for	Araba*	Álava
ES-Z, Name for	Zaragoza	Zaragoza
ES-ZA, Name for	Zamora	Zamora
ET-AA, Name for	Addis Ababa	Addis Abeba
ET-AF, Name for	Afar	Afar
ET-AM, Name for	Amara	Amhara
ET-BE, Name for	Benshangul-Gumaz	Benishangul-Gumuz
ET-DD, Name for	Dire Dawa	Dire Dawa
ET-GA, Name for	Gambela Peoples	Gambela
ET-HA, Name for	Harari People	Harare
ET-OR, Name for	Oromia	Oromiya
ET-SN, Name for	Southern Nations, Nationalities and Peoples	Yedebub Biheroch Bihereseboch na Hizboch
ET-SO, Name for	Somali	Somali
ET-TI, Name for	Tigrai	Tigray
FI-01, Name for	Åland	Åland
FI-02, Name for	Etelä-Karjala	Zuid-Karelië
FI-03, Name for	Etelä-Pohjanmaa	Zuid-Ostrobothnië
FI-04, Name for	Etelä-Savo	Zuid-Savonië
FI-05, Name for	Kainuu	Kainuu
FI-06, Name for	Kanta-Häme	Kanta-Häme
FI-07, Name for	Keski-Pohjanmaa	Centraal-Ostrobothnië
FI-08, Name for	Keski-Suomi	Centraal-Finland
FI-09, Name for	Kymenlaakso	Kymenlaakso
FI-10, Name for	Lappi	Lapland
FI-11, Name for	Pirkanmaa	Pirkanmaa
FI-12, Name for	Pohjanmaa	Ostrobothnië
FI-13, Name for	Pohjois-Karjala	Noord-Karelië
FI-14, Name for	Pohjois-Pohjanmaa	Noord-Ostrobothnië
FI-15, Name for	Pohjois-Savo	Noord-Savonië
FI-16, Name for	Päijät-Häme	Päijät-Häme
FI-17, Name for	Satakunta	Satakunta
FI-18, Name for	Uusimaa	Uusimaa
FI-19, Name for	Varsinais-Suomi	Zuidwest-Finland
FJ-01, Name for	Ba	Ba
FJ-02, Name for	Bua	Bua
FJ-03, Name for	Cakaudrove	Cakaudrove
FJ-04, Name for	Kadavu	Kadavu
FJ-05, Name for	Lau	Lau
FJ-06, Name for	Lomaiviti	Lomaiviti
FJ-07, Name for	Macuata	Macuata
FJ-08, Name for	Nadroga and Navosa	Nadroga-Navosa
FJ-09, Name for	Naitasiri	Naitasiri
FJ-10, Name for	Namosi	Namosi
FJ-11, Name for	Ra	Ra
FJ-12, Name for	Rewa	Rewa
FJ-13, Name for	Serua	Serua
FJ-14, Name for	Tailevu	Tailevu
FJ-C, Name for	Central	Central
FJ-E, Name for	Eastern	Oost
FJ-N, Name for	Northern	Northern
FJ-R, Name for	Rotuma	Rotuma
FJ-W, Name for	Western	Western
FM-KSA, Name for	Kosrae	Kosrae
FM-PNI, Name for	Pohnpei	Pohnpei
FM-TRK, Name for	Chuuk	Chuuk
FM-YAP, Name for	Yap	Yap
FR-01, Name for	Ain	Ain
FR-02, Name for	Aisne	Aisne
FR-03, Name for	Allier	Allier
FR-04, Name for	Alpes-de-Haute-Provence	Alpen van Hoog-Provence
FR-05, Name for	Hautes-Alpes	Hoog-Alpen
FR-06, Name for	Alpes-Maritimes	Zee-Alpen
FR-07, Name for	Ardèche	Ardèche
FR-08, Name for	Ardennes	Ardennen
FR-09, Name for	Ariège	Ariège
FR-10, Name for	Aube	Aube
FR-11, Name for	Aude	Aude
FR-12, Name for	Aveyron	Aveyron
FR-13, Name for	Bouches-du-Rhône	Oevers van de Rhône
FR-14, Name for	Calvados	Calvados
FR-15, Name for	Cantal	Cantal
FR-16, Name for	Charente	Charente
FR-17, Name for	Charente-Maritime	Zee-Charente
FR-18, Name for	Cher	Cher
FR-19, Name for	Corrèze	Corrèze
FR-20R, Name for	Corse	Corsica
FR-21, Name for	Côte-d'Or	Goudkust
FR-22, Name for	Côtes-d'Armor	Kusten van Armor
FR-23, Name for	Creuse	Creuse
FR-24, Name for	Dordogne	Dordogne
FR-25, Name for	Doubs	Doubs
FR-26, Name for	Drôme	Drôme
FR-27, Name for	Eure	Eure
FR-28, Name for	Eure-et-Loir	Eure en Loir
FR-29, Name for	Finistère	Finistère
FR-2A, Name for	Corse-du-Sud	Zuid-Corsica
FR-2B, Name for	Haute-Corse	Hoog-Corsica
FR-30, Name for	Gard	Gard
FR-31, Name for	Haute-Garonne	Hoog-Garonne
FR-32, Name for	Gers	Gers
FR-33, Name for	Gironde	Gironde
FR-34, Name for	Hérault	Hérault
FR-35, Name for	Ille-et-Vilaine	Ille en Vilaine
FR-36, Name for	Indre	Indre
FR-37, Name for	Indre-et-Loire	Indre en Loire
FR-38, Name for	Isère	Isère
FR-39, Name for	Jura	Jura
FR-40, Name for	Landes	Landes
FR-41, Name for	Loir-et-Cher	Loir en Cher
FR-42, Name for	Loire	Loire
FR-43, Name for	Haute-Loire	Hoog-Loire
FR-44, Name for	Loire-Atlantique	Loire-Atlantisch
FR-45, Name for	Loiret	Loiret
FR-46, Name for	Lot	Lot
FR-47, Name for	Lot-et-Garonne	Lot en Garonne
FR-48, Name for	Lozère	Lozère
FR-49, Name for	Maine-et-Loire	Maine en Loire
FR-50, Name for	Manche	Manche
FR-51, Name for	Marne	Marne
FR-52, Name for	Haute-Marne	Haute-Marne
FR-53, Name for	Mayenne	Mayenne
FR-54, Name for	Meurthe-et-Moselle	Meurthe en Moezel
FR-55, Name for	Meuse	Meuse
FR-56, Name for	Morbihan	Morbihan
FR-57, Name for	Moselle	Moezel
FR-58, Name for	Nièvre	Nièvre
FR-59, Name for	Nord	Noord
FR-60, Name for	Oise	Oise
FR-61, Name for	Orne	Orne
FR-62, Name for	Pas-de-Calais	Nauw van Calais
FR-63, Name for	Puy-de-Dôme	Puy-de-Dôme
FR-64, Name for	Pyrénées-Atlantiques	Pyreneeën-Atlantisch
FR-65, Name for	Hautes-Pyrénées	Hoog-Pyreneeën
FR-66, Name for	Pyrénées-Orientales	Oost-Pyreneeën
FR-67, Name for	Bas-Rhin	Laag-Rijn
FR-68, Name for	Haut-Rhin	Hoog-Rijn
FR-69, Name for	Rhône	Rhône
FR-70, Name for	Haute-Saône	Hoog-Saône
FR-71, Name for	Saône-et-Loire	Saône en Loire
FR-72, Name for	Sarthe	Sarthe
FR-73, Name for	Savoie	Savoie
FR-74, Name for	Haute-Savoie	Hoog-Savoie
FR-75, Name for	Paris	Parijs
FR-76, Name for	Seine-Maritime	Zee-Seine
FR-77, Name for	Seine-et-Marne	Seine en Marne
FR-78, Name for	Yvelines	Yvelines
FR-79, Name for	Deux-Sèvres	Deux-Sèvres
FR-80, Name for	Somme	Somme
FR-81, Name for	Tarn	Tarn
FR-82, Name for	Tarn-et-Garonne	Tarn en Garonne
FR-83, Name for	Var	Var
FR-84, Name for	Vaucluse	Vaucluse
FR-85, Name for	Vendée	Vendée
FR-86, Name for	Vienne	Vienne
FR-87, Name for	Haute-Vienne	Hoog-Vienne
FR-88, Name for	Vosges	Vogezen
FR-89, Name for	Yonne	Yonne
FR-90, Name for	Territoire de Belfort	Belfort, Territorium van
FR-91, Name for	Essonne	Essonne
FR-92, Name for	Hauts-de-Seine	Hoog-Seine
FR-93, Name for	Seine-Saint-Denis	Seine-Saint-Denis
FR-94, Name for	Val-de-Marne	Marne Vallei
FR-95, Name for	Val-d'Oise	Val-d'Oise
FR-971, Name for	Guadeloupe	Guadeloupe
FR-972, Name for	Martinique	Martinique
FR-973, Name for	Guyane (française)	Frans-Guyane
FR-974, Name for	La Réunion	La Réunion
FR-976, Name for	Mayotte	Mayotte
FR-ARA, Name for	Auvergne-Rhône-Alpes	Auvergne-Rhône-Alpes
FR-BFC, Name for	Bourgogne-Franche-Comté	Bourgogne-Franche-Comté
FR-BL, Name for	Saint-Barthélemy	Saint-Barthélemy
FR-BRE, Name for	Bretagne	Bretagne
FR-CP, Name for	Clipperton	Clipperton
FR-CVL, Name for	Centre-Val de Loire	Centre-Val de Loire
FR-GES, Name for	Grand-Est	Grand-Est
FR-GF, Name for	Guyane (française)	Frans-Guyane
FR-GP, Name for	Guadeloupe	Guadeloupe
FR-HDF, Name for	Hauts-de-France	Hauts-de-France
FR-IDF, Name for	Île-de-France	Île-de-France
FR-MF, Name for	Saint-Martin	Sint Maarten
FR-MQ, Name for	Martinique	Martinique
FR-NAQ, Name for	Nouvelle-Aquitaine	Nouvelle-Aquitaine
FR-NC, Name for	Nouvelle-Calédonie	Nieuw-Caledonië
FR-NOR, Name for	Normandie	Normandië
FR-OCC, Name for	Occitanie	Occitanie
FR-PAC, Name for	Provence-Alpes-Côte-d’Azur	Provence-Alpes-Côte-d'Azur
FR-PDL, Name for	Pays-de-la-Loire	Pays-de-la-Loire
FR-PF, Name for	Polynésie française	Frans-Polynesië
FR-PM, Name for	Saint-Pierre-et-Miquelon	Saint-Pierre-et-Miquelon
FR-RE, Name for	La Réunion	La Réunion
FR-TF, Name for	Terres australes françaises	Franse Zuidelijke Gebieden
FR-WF, Name for	Wallis-et-Futuna	Wallis en Futuna
FR-YT, Name for	Mayotte	Mayotte
GA-1, Name for	Estuaire	Estuaire
GA-2, Name for	Haut-Ogooué	Haut-Ogooué
GA-3, Name for	Moyen-Ogooué	Moyen-Ogooué
GA-4, Name for	Ngounié	Ngounié
GA-5, Name for	Nyanga	Nyanga
GA-6, Name for	Ogooué-Ivindo	Ogooué-Ivindo
GA-7, Name for	Ogooué-Lolo	Ogooué-Lolo
GA-8, Name for	Ogooué-Maritime	Ogooué-Maritime
GA-9, Name for	Woleu-Ntem	Woleu-Ntem
GB-ABC, Name for	Armagh City, Banbridge and Craigavon	Armagh, Banbridge and Craigavon
GB-ABD, Name for	Aberdeenshire	Aberdeenshire
GB-ABE, Name for	Aberdeen City	Aberdeen
GB-AGB, Name for	Argyll and Bute	Argyll en Bute
GB-AGY, Name for	Isle of Anglesey [Sir Ynys Môn GB-YNM]	Anglesey
GB-AND, Name for	Ards and North Down	Ards en North Down
GB-ANN, Name for	Antrim and Newtownabbey	Antrim en Newtownabbey
GB-ANS, Name for	Angus	Angus
GB-BAS, Name for	Bath and North East Somerset	Bath en Noord-Oost-Somerset
GB-BBD, Name for	Blackburn with Darwen	Blackburn met Darwen
GB-BCP, Name for	Bournemouth, Christchurch and Poole	Bournemouth, Christchurch and Poole
GB-BDF, Name for	Bedford	Bedford
GB-BDG, Name for	Barking and Dagenham	Barking en Dagenham
GB-BEN, Name for	Brent	Brent
GB-BEX, Name for	Bexley	Bexley
GB-BFS, Name for	Belfast City	Belfast
GB-BGE, Name for	Bridgend [Pen-y-bont ar Ogwr GB-POG]	Bridgend
GB-BGW, Name for	Blaenau Gwent	Blaenau Gwent
GB-BIR, Name for	Birmingham	Birmingham
GB-BKM, Name for	Buckinghamshire	Buckinghamshire
GB-BNE, Name for	Barnet	Barnet
GB-BNH, Name for	Brighton and Hove	Brighton en Hove
GB-BNS, Name for	Barnsley	Barnsley
GB-BOL, Name for	Bolton	Bolton
GB-BPL, Name for	Blackpool	Blackpool
GB-BRC, Name for	Bracknell Forest	Bracknell Forest
GB-BRD, Name for	Bradford	Bradford
GB-BRY, Name for	Bromley	Bromley
GB-BST, Name for	Bristol, City of	Bristol, City of
GB-BUR, Name for	Bury	Bury
GB-CAM, Name for	Cambridgeshire	Cambridgeshire
GB-CAY, Name for	Caerphilly [Caerffili GB-CAF]	Caerphilly
GB-CBF, Name for	Central Bedfordshire	Centraal-Bedfordshire
GB-CCG, Name for	Causeway Coast and Glens	Causeway Coast en Glens
GB-CGN, Name for	Ceredigion [Sir Ceredigion]	Ceredigion
GB-CHE, Name for	Cheshire East	Oost-Cheshire
GB-CHW, Name for	Cheshire West and Chester	West-Cheshire en Chester
GB-CLD, Name for	Calderdale	Calderdale
GB-CLK, Name for	Clackmannanshire	Clackmannanshire
GB-CMA, Name for	Cumbria	Cumbria
GB-CMD, Name for	Camden	Camden
GB-CMN, Name for	Carmarthenshire [Sir Gaerfyrddin GB-GFY]	Carmarthenshire
GB-CON, Name for	Cornwall	Cornwall
GB-COV, Name for	Coventry	Coventry
GB-CRF, Name for	Cardiff [Caerdydd GB-CRD]	Cardiff
GB-CRY, Name for	Croydon	Croydon
GB-CWY, Name for	Conwy	Conwy
GB-DAL, Name for	Darlington	Darlington
GB-DBY, Name for	Derbyshire	Derbyshire
GB-DEN, Name for	Denbighshire [Sir Ddinbych GB-DDB]	Denbighshire
GB-DER, Name for	Derby	Derby
GB-DEV, Name for	Devon	Devon
GB-DGY, Name for	Dumfries and Galloway	Dumfries en Galloway
GB-DNC, Name for	Doncaster	Doncaster
GB-DND, Name for	Dundee City	Dundee
GB-DOR, Name for	Dorset	Dorset
GB-DRS, Name for	Derry and Strabane	Derry en Strabane
GB-DUD, Name for	Dudley	Dudley
GB-DUR, Name for	Durham, County	Durham
GB-EAL, Name for	Ealing	Ealing
GB-EAY, Name for	East Ayrshire	East Ayrshire
GB-EDH, Name for	Edinburgh, City of	Edinburgh, City of
GB-EDU, Name for	East Dunbartonshire	East Dunbartonshire
GB-ELN, Name for	East Lothian	Oost-Lothian
GB-ELS, Name for	Eilean Siar	Eilean Siar
GB-ENF, Name for	Enfield	Enfield
GB-ENG, Name for	England	Engeland
GB-ERW, Name for	East Renfrewshire	East Renfrewshire
GB-ERY, Name for	East Riding of Yorkshire	East Riding of Yorkshire
GB-ESS, Name for	Essex	Essex
GB-ESX, Name for	East Sussex	Oost-Sussex
GB-FAL, Name for	Falkirk	Falkirk
GB-FIF, Name for	Fife	Fife
GB-FLN, Name for	Flintshire [Sir y Fflint GB-FFL]	Flintshire
GB-FMO, Name for	Fermanagh and Omagh	Fermanagh en Omagh
GB-GAT, Name for	Gateshead	Gateshead
GB-GLG, Name for	Glasgow City	Glasgow
GB-GLS, Name for	Gloucestershire	Gloucestershire
GB-GRE, Name for	Greenwich	Greenwich
GB-GWN, Name for	Gwynedd	Gwynedd
GB-HAL, Name for	Halton	Halton
GB-HAM, Name for	Hampshire	Hampshire
GB-HAV, Name for	Havering	Havering
GB-HCK, Name for	Hackney	Hackney
GB-HEF, Name for	Herefordshire	Herefordshire
GB-HIL, Name for	Hillingdon	Hillingdon
GB-HLD, Name for	Highland	Highland
GB-HMF, Name for	Hammersmith and Fulham	Hammersmith en Fulham
GB-HNS, Name for	Hounslow	Hounslow
GB-HPL, Name for	Hartlepool	Hartlepool
GB-HRT, Name for	Hertfordshire	Hertfordshire
GB-HRW, Name for	Harrow	Harrow
GB-HRY, Name for	Haringey	Haringey
GB-IOS, Name for	Isles of Scilly	Scilly-eiland
GB-IOW, Name for	Isle of Wight	Wight-eiland
GB-ISL, Name for	Islington	Islington
GB-IVC, Name for	Inverclyde	Inverclyde
GB-KEC, Name for	Kensington and Chelsea	Kensington en Chelsea
GB-KEN, Name for	Kent	Kent
GB-KHL, Name for	Kingston upon Hull	Kingston upon Hull
GB-KIR, Name for	Kirklees	Kirklees
GB-KTT, Name for	Kingston upon Thames	Kingston upon Thames
GB-KWL, Name for	Knowsley	Knowsley
GB-LAN, Name for	Lancashire	Lancashire
GB-LBC, Name for	Lisburn and Castlereagh	Lisburn en Castlereagh
GB-LBH, Name for	Lambeth	Lambeth
GB-LCE, Name for	Leicester	Leicester
GB-LDS, Name for	Leeds	Leeds
GB-LEC, Name for	Leicestershire	Leicestershire
GB-LEW, Name for	Lewisham	Lewisham
GB-LIN, Name for	Lincolnshire	Lincolnshire
GB-LIV, Name for	Liverpool	Liverpool
GB-LND, Name for	London, City of	London, City of
GB-LUT, Name for	Luton	Luton
GB-MAN, Name for	Manchester	Manchester
GB-MDB, Name for	Middlesbrough	Middlesbrough
GB-MDW, Name for	Medway	Medway
GB-MEA, Name for	Mid and East Antrim	Mid and East Antrim
GB-MIK, Name for	Milton Keynes	Milton Keynes
GB-MLN, Name for	Midlothian	Midlothian
GB-MON, Name for	Monmouthshire [Sir Fynwy GB-FYN]	Monmouthshire
GB-MRT, Name for	Merton	Merton
GB-MRY, Name for	Moray	Moray
GB-MTY, Name for	Merthyr Tydfil [Merthyr Tudful GB-MTU]	Merthyr Tydfil
GB-MUL, Name for	Mid-Ulster	Mid Ulster
GB-NAY, Name for	North Ayrshire	Noord-Ayrshire
GB-NBL, Name for	Northumberland	Northumberland
GB-NEL, Name for	North East Lincolnshire	North East Lincolnshire
GB-NET, Name for	Newcastle upon Tyne	Newcastle upon Tyne
GB-NFK, Name for	Norfolk	Norfolk
GB-NGM, Name for	Nottingham	Nottingham
GB-NIR, Name for	Northern Ireland	Noord-Ierland
GB-NLK, Name for	North Lanarkshire	North Lanarkshire
GB-NLN, Name for	North Lincolnshire	North Lincolnshire
GB-NMD, Name for	Newry, Mourne and Down	Newry, Mourne and Down
GB-NSM, Name for	North Somerset	Noord-Somerset
GB-NTH, Name for	Northamptonshire	Northamptonshire
GB-NTL, Name for	Neath Port Talbot [Castell-nedd Port Talbot GB-CTL]	Neath Port Talbot
GB-NTT, Name for	Nottinghamshire	Nottinghamshire
GB-NTY, Name for	North Tyneside	Noord-Tyneside
GB-NWM, Name for	Newham	Newham
GB-NWP, Name for	Newport [Casnewydd GB-CNW]	Newport
GB-NYK, Name for	North Yorkshire	North Yorkshire
GB-OLD, Name for	Oldham	Oldham
GB-ORK, Name for	Orkney Islands	Orkney-eilanden
GB-OXF, Name for	Oxfordshire	Oxfordshire
GB-PEM, Name for	Pembrokeshire [Sir Benfro GB-BNF]	Pembrokeshire
GB-PKN, Name for	Perth and Kinross	Perth en Kinross
GB-PLY, Name for	Plymouth	Plymouth
GB-POR, Name for	Portsmouth	Portsmouth
GB-POW, Name for	Powys	Powys
GB-PTE, Name for	Peterborough	Peterborough
GB-RCC, Name for	Redcar and Cleveland	Redcar en Cleveland
GB-RCH, Name for	Rochdale	Rochdale
GB-RCT, Name for	Rhondda Cynon Taff [Rhondda CynonTaf]	Rhondda Cynon Taf
GB-RDB, Name for	Redbridge	Redbridge
GB-RDG, Name for	Reading	Reading
GB-RFW, Name for	Renfrewshire	Renfrewshire
GB-RIC, Name for	Richmond upon Thames	Richmond upon Thames
GB-ROT, Name for	Rotherham	Rotherham
GB-RUT, Name for	Rutland	Rutland
GB-SAW, Name for	Sandwell	Sandwell
GB-SAY, Name for	South Ayrshire	South Ayrshire
GB-SCB, Name for	Scottish Borders	Scottish Borders
GB-SCT, Name for	Scotland	Schotland
GB-SFK, Name for	Suffolk	Suffolk
GB-SFT, Name for	Sefton	Sefton
GB-SGC, Name for	South Gloucestershire	South Gloucestershire
GB-SHF, Name for	Sheffield	Sheffield
GB-SHN, Name for	St. Helens	St. Helens
GB-SHR, Name for	Shropshire	Shropshire
GB-SKP, Name for	Stockport	Stockport
GB-SLF, Name for	Salford	Salford
GB-SLG, Name for	Slough	Slough
GB-SLK, Name for	South Lanarkshire	South Lanarkshire
GB-SND, Name for	Sunderland	Sunderland
GB-SOL, Name for	Solihull	Solihull
GB-SOM, Name for	Somerset	Somerset
GB-SOS, Name for	Southend-on-Sea	Southend aan Zee
GB-SRY, Name for	Surrey	Surrey
GB-STE, Name for	Stoke-on-Trent	Stoke aan Trent
GB-STG, Name for	Stirling	Stirling
GB-STH, Name for	Southampton	Southampton
GB-STN, Name for	Sutton	Sutton
GB-STS, Name for	Staffordshire	Staffordshire
GB-STT, Name for	Stockton-on-Tees	Stockton aan Tees
GB-STY, Name for	South Tyneside	Zuid-Tyneside
GB-SWA, Name for	Swansea [Abertawe GB-ATA]	Swansea
GB-SWD, Name for	Swindon	Swindon
GB-SWK, Name for	Southwark	Southwark
GB-TAM, Name for	Tameside	Tameside
GB-TFW, Name for	Telford and Wrekin	Telford en Wrekin
GB-THR, Name for	Thurrock	Thurrock
GB-TOB, Name for	Torbay	Torbay
GB-TOF, Name for	Torfaen [Tor-faen]	Torfaen
GB-TRF, Name for	Trafford	Trafford
GB-TWH, Name for	Tower Hamlets	Tower Hamlets
GB-VGL, Name for	Vale of Glamorgan, The [Bro Morgannwg GB-BMG]	Vale of Glamorgan
GB-WAR, Name for	Warwickshire	Warwickshire
GB-WBK, Name for	West Berkshire	Westberkshire
GB-WDU, Name for	West Dunbartonshire	Westdunbartonshire
GB-WFT, Name for	Waltham Forest	Waltham Forest
GB-WGN, Name for	Wigan	Wigan
GB-WIL, Name for	Wiltshire	Wiltshire
GB-WKF, Name for	Wakefield	Wakefield
GB-WLL, Name for	Walsall	Walsall
GB-WLN, Name for	West Lothian	West-Lothian
GB-WLS, Name for	Wales [Cymru GB-CYM]	Wales
GB-WLV, Name for	Wolverhampton	Wolverhampton
GB-WND, Name for	Wandsworth	Wandsworth
GB-WNM, Name for	Windsor and Maidenhead	Windsor en Maidenhead
GB-WOK, Name for	Wokingham	Wokingham
GB-WOR, Name for	Worcestershire	Worcestershire
GB-WRL, Name for	Wirral	Wirral
GB-WRT, Name for	Warrington	Warrington
GB-WRX, Name for	Wrexham [Wrecsam GB-WRC]	Wrexham
GB-WSM, Name for	Westminster	Westminster
GB-WSX, Name for	West Sussex	West-Sussex
GB-YOR, Name for	York	York
GB-ZET, Name for	Shetland Islands	Shetland-eilanden
GD-01, Name for	Saint Andrew	Saint Andrew
GD-02, Name for	Saint David	Saint David
GD-03, Name for	Saint George	Saint George
GD-04, Name for	Saint John	Saint John
GD-05, Name for	Saint Mark	Saint Mark
GD-06, Name for	Saint Patrick	Saint Patrick
GD-10, Name for	Southern Grenadine Islands	Southern Grenadine Islands
GE-AB, Name for	Abkhazia	Abchazië
GE-AJ, Name for	Ajaria	Adzjarië
GE-GU, Name for	Guria	Guria
GE-IM, Name for	Imereti	Imereti
GE-KA, Name for	K'akheti	Kakheti
GE-KK, Name for	Kvemo Kartli	Kvemo Kartli
GE-MM, Name for	Mtskheta-Mtianeti	Mtskheta-Mtianeti
GE-RL, Name for	Rach'a-Lechkhumi-Kvemo Svaneti	Racha-Lechkhumi en Kvemo Svaneti
GE-SJ, Name for	Samtskhe-Javakheti	Samtskhe-Javakheti
GE-SK, Name for	Shida Kartli	Shida Kartli
GE-SZ, Name for	Samegrelo-Zemo Svaneti	Samegrelo-Zemo Svaneti
GE-TB, Name for	Tbilisi	Tbilisi
GH-AA, Name for	Greater Accra	Groot-Accra
GH-AF, Name for	Ahafo	Ahafo
GH-AH, Name for	Ashanti	Ashanti
GH-BE, Name for	Bono East	Bono Oost
GH-BO, Name for	Bono	Bono
GH-CP, Name for	Central	Central
GH-EP, Name for	Eastern	Oost
GH-NE, Name for	North East	Noord-Oost
GH-NP, Name for	Northern	Northern
GH-OT, Name for	Oti	Oti
GH-SV, Name for	Savannah	Savannah
GH-TV, Name for	Volta	Volta
GH-UE, Name for	Upper East	Upper East
GH-UW, Name for	Upper West	Upper West
GH-WN, Name for	Western North	Western North
GH-WP, Name for	Western	Western
GL-AV, Name for	Avannaata Kommunia	Gemeente Qeqqata
GL-KU, Name for	Kommune Kujalleq	Gemeente Kujalleq
GL-QE, Name for	Qeqqata Kommunia	Gemeente Qeqqata
GL-QT, Name for	Kommune Qeqertalik	Gemeente Qeqertalik
GL-SM, Name for	Kommuneqarfik Sermersooq	Gemeente Sermersooq
GM-B, Name for	Banjul	Banjul
GM-L, Name for	Lower River	Lower River
GM-M, Name for	Central River	Central River
GM-N, Name for	North Bank	North Bank
GM-U, Name for	Upper River	Upper River
GM-W, Name for	Western	Western
GN-B, Name for	Boké	Boké
GN-BE, Name for	Beyla	Beyla
GN-BF, Name for	Boffa	Boffa
GN-BK, Name for	Boké	Boké
GN-C, Name for	Conakry	Conakry
GN-CO, Name for	Coyah	Coyah
GN-D, Name for	Kindia	Kindia
GN-DB, Name for	Dabola	Dabola
GN-DI, Name for	Dinguiraye	Dinguiraye
GN-DL, Name for	Dalaba	Dalaba
GN-DU, Name for	Dubréka	Dubréka
GN-F, Name for	Faranah	Faranah
GN-FA, Name for	Faranah	Faranah
GN-FO, Name for	Forécariah	Forécariah
GN-FR, Name for	Fria	Fria
GN-GA, Name for	Gaoual	Gaoual
GN-GU, Name for	Guékédou	Guékédou
GN-K, Name for	Kankan	Kankan
GN-KA, Name for	Kankan	Kankan
GN-KB, Name for	Koubia	Koubia
GN-KD, Name for	Kindia	Kindia
GN-KE, Name for	Kérouané	Kérouané
GN-KN, Name for	Koundara	Koundara
GN-KO, Name for	Kouroussa	Kouroussa
GN-KS, Name for	Kissidougou	Kissidougou
GN-L, Name for	Labé	Labé
GN-LA, Name for	Labé	Labé
GN-LE, Name for	Lélouma	Lélouma
GN-LO, Name for	Lola	Lola
GN-M, Name for	Mamou	Mamou
GN-MC, Name for	Macenta	Macenta
GN-MD, Name for	Mandiana	Mandiana
GN-ML, Name for	Mali	Mali
GN-MM, Name for	Mamou	Mamou
GN-N, Name for	Nzérékoré	Nzérékoré
GN-NZ, Name for	Nzérékoré	Nzérékoré
GN-PI, Name for	Pita	Pita
GN-SI, Name for	Siguiri	Siguiri
GN-TE, Name for	Télimélé	Télimélé
GN-TO, Name for	Tougué	Tougué
GN-YO, Name for	Yomou	Yomou
GQ-AN, Name for	Annobon	Annobón
GQ-BN, Name for	Bioko Nord	Bioko Norte
GQ-BS, Name for	Bioko Sud	Bioko Sur
GQ-C, Name for	Região Continental	Continentale Regio
GQ-CS, Name for	Centro Sud	Centro Sur
GQ-DJ, Name for	Djibloho	Djibouti
GQ-I, Name for	Região Insular	Eilandenregio
GQ-KN, Name for	Kié-Ntem	Kié-Ntem
GQ-LI, Name for	Litoral	Litoral
GQ-WN, Name for	Wele-Nzas	Wele-Nzas
GR-69, Name for	Ágion Óros	Oros Athos
GR-A, Name for	Anatolikí Makedonía kai Thráki	Oost-Macedonië en Thracië
GR-B, Name for	Kentrikí Makedonía	Centraal-Macedonië
GR-C, Name for	Dytikí Makedonía	West-Macedonië
GR-D, Name for	Ípeiros	Epirus
GR-E, Name for	Thessalía	Thessalië
GR-F, Name for	Ionía Nísia	Ionische Eilanden
GR-G, Name for	Dytikí Elláda	West-Griekenland
GR-H, Name for	Stereá Elláda	Centraal-Griekenland
GR-I, Name for	Attikí	Attica
GR-J, Name for	Pelopónnisos	Peloponnesos
GR-K, Name for	Vóreio Aigaío	Noord-Egeïsche Eilanden
GR-L, Name for	Nótio Aigaío	Zuid-Egeïsche Eilanden
GR-M, Name for	Kríti	Kreta
GT-AV, Name for	Alta Verapaz	Alta Verapaz
GT-BV, Name for	Baja Verapaz	Baja Verapaz
GT-CM, Name for	Chimaltenango	Chimaltenango
GT-CQ, Name for	Chiquimula	Chiquimula
GT-ES, Name for	Escuintla	Escuintla
GT-GU, Name for	Guatemala	Guatemala
GT-HU, Name for	Huehuetenango	Huehuetenango
GT-IZ, Name for	Izabal	Izabal
GT-JA, Name for	Jalapa	Jalapa
GT-JU, Name for	Jutiapa	Jutiapa
GT-PE, Name for	Petén	Petén
GT-PR, Name for	El Progreso	El Progreso
GT-QC, Name for	Quiché	Quiché
GT-QZ, Name for	Quetzaltenango	Quetzaltenango
GT-RE, Name for	Retalhuleu	Retalhuleu
GT-SA, Name for	Sacatepéquez	Sacatepéquez
GT-SM, Name for	San Marcos	San Marcos
GT-SO, Name for	Sololá	Sololá
GT-SR, Name for	Santa Rosa	Santa Rosa
GT-SU, Name for	Suchitepéquez	Suchitepéquez
GT-TO, Name for	Totonicapán	Totonicapán
GT-ZA, Name for	Zacapa	Zacapa
GW-BA, Name for	Bafatá	Bafatá
GW-BL, Name for	Bolama / Bijagós	Boloma; Bissagoseilanden
GW-BM, Name for	Biombo	Biombo
GW-BS, Name for	Bissau	Bissau
GW-CA, Name for	Cacheu	Cacheu
GW-GA, Name for	Gabú	Gabú
GW-L, Name for	Leste	West
GW-N, Name for	Norte	Noord
GW-OI, Name for	Oio	Oio
GW-QU, Name for	Quinara	Quinara
GW-S, Name for	Sul	Zuid
GW-TO, Name for	Tombali	Tombali
GY-BA, Name for	Barima-Waini	Barima-Waini
GY-CU, Name for	Cuyuni-Mazaruni	Cuyuni-Mazaruniazaruni
GY-DE, Name for	Demerara-Mahaica	Demerara-Mahaica
GY-EB, Name for	East Berbice-Corentyne	Oost-Berbice-Corantijn
GY-ES, Name for	Essequibo Islands-West Demerara	Essequibo-eilanden-West-Demerara
GY-MA, Name for	Mahaica-Berbice	Mahaica-Berbice
GY-PM, Name for	Pomeroon-Supenaam	Pomeroon-Supenaam
GY-PT, Name for	Potaro-Siparuni	Potaro-Siparuni
GY-UD, Name for	Upper Demerara-Berbice	Boven-Demerara-Berbice
GY-UT, Name for	Upper Takutu-Upper Essequibo	Boven-Takutu-Boven-Essequibo
HN-AT, Name for	Atlántida	Atlántida
HN-CH, Name for	Choluteca	Choluteca
HN-CL, Name for	Colón	Colón
HN-CM, Name for	Comayagua	Comayagua
HN-CP, Name for	Copán	Copán
HN-CR, Name for	Cortés	Cortés
HN-EP, Name for	El Paraíso	El Paraíso
HN-FM, Name for	Francisco Morazán	Francisco Morazán
HN-GD, Name for	Gracias a Dios	Gracias a Dios
HN-IB, Name for	Islas de la Bahía	Islas de la Bahía
HN-IN, Name for	Intibucá	Intibucá
HN-LE, Name for	Lempira	Hondurese lempira
HN-LP, Name for	La Paz	La Paz
HN-OC, Name for	Ocotepeque	Ocotepeque
HN-OL, Name for	Olancho	Olancho
HN-SB, Name for	Santa Bárbara	Santa Bárbara
HN-VA, Name for	Valle	Valle
HN-YO, Name for	Yoro	Yoro
HR-01, Name for	Zagrebačka županija	Zagreb, Provincie
HR-02, Name for	Krapinsko-zagorska županija	Krapina-Zagorje, Provincie
HR-03, Name for	Sisačko-moslavačka županija	Sisak-Moslavina, Provincie
HR-04, Name for	Karlovačka županija	Karlovac, Provincie
HR-05, Name for	Varaždinska županija	Varazdin, Provincie
HR-06, Name for	Koprivničko-križevačka županija	Koprivnica-Križevci, Provincie
HR-07, Name for	Bjelovarsko-bilogorska županija	Bjelovar-Bilogora, Provincie
HR-08, Name for	Primorsko-goranska županija	Primorje-Gorski, Provincie
HR-09, Name for	Ličko-senjska županija	Lika-Senj, Provincie
HR-10, Name for	Virovitičko-podravska županija	Virovitica-Podravina, Provincie
HR-11, Name for	Požeško-slavonska županija	Pozega-Slavonië, Provincie
HR-12, Name for	Brodsko-posavska županija	Brod-Posavina, Provincie
HR-13, Name for	Zadarska županija	Zadar, Provincie
HR-14, Name for	Osječko-baranjska županija	Osijek-Baranja, Provincie
HR-15, Name for	Šibensko-kninska županija	Sibenik-Knin, Provincie
HR-16, Name for	Vukovarsko-srijemska županija	Vukovar-Srijem, Provincie
HR-17, Name for	Splitsko-dalmatinska županija	Split-Dalmatië, Provincie
HR-18, Name for	Istarska županija	Istrië, Provincie
HR-19, Name for	Dubrovačko-neretvanska županija	Dubrovnik-Neretva, Provincie
HR-20, Name for	Međimurska županija	Medjimurje, Provincie
HR-21, Name for	Grad Zagreb	Zagreb (stad)
HT-AR, Name for	Artibonite	Artibonite
HT-CE, Name for	Centre	Centre
HT-GA, Name for	Grandans	Grand' Anse
HT-ND, Name for	Nord	Noord
HT-NE, Name for	Nord-Est	Nord-Est
HT-NI, Name for	Nip	Nippes
HT-NO, Name for	Nord-Ouest	Nord-Ouest
HT-OU, Name for	Lwès	Ouest
HT-SD, Name for	Sid	Sud
HT-SE, Name for	Sidès	Sud-Est
HU-BA, Name for	Baranya	Baranya
HU-BC, Name for	Békéscsaba	Békéscsaba
HU-BE, Name for	Békés	Békés
HU-BK, Name for	Bács-Kiskun	Bács-Kiskun
HU-BU, Name for	Budapest	Budapest
HU-BZ, Name for	Borsod-Abaúj-Zemplén	Borsod-Abaúj-Zemplén
HU-CS, Name for	Csongrád	Csongrád
HU-DE, Name for	Debrecen	Debrecen
HU-DU, Name for	Dunaújváros	Dunaújváros
HU-EG, Name for	Eger	Eger
HU-ER, Name for	Érd	Érd
HU-FE, Name for	Fejér	Fejér
HU-GS, Name for	Győr-Moson-Sopron	Győr-Moson-Sopron
HU-GY, Name for	Győr	Győr
HU-HB, Name for	Hajdú-Bihar	Hajdú-Bihar
HU-HE, Name for	Heves	Heves
HU-HV, Name for	Hódmezővásárhely	Hódmezővásárhely
HU-JN, Name for	Jász-Nagykun-Szolnok	Jász-Nagykun-Szolnok
HU-KE, Name for	Komárom-Esztergom	Komárom-Esztergom
HU-KM, Name for	Kecskemét	Kecskemét
HU-KV, Name for	Kaposvár	Kaposvár
HU-MI, Name for	Miskolc	Miskolc
HU-NK, Name for	Nagykanizsa	Nagykanizsa
HU-NO, Name for	Nógrád	Nógrád
HU-NY, Name for	Nyíregyháza	Nyíregyháza
HU-PE, Name for	Pest	Pest
HU-PS, Name for	Pécs	Pécs
HU-SD, Name for	Szeged	Szeged
HU-SF, Name for	Székesfehérvár	Székesfehérvár
HU-SH, Name for	Szombathely	Szombathely
HU-SK, Name for	Szolnok	Szolnok
HU-SN, Name for	Sopron	Sopron
HU-SO, Name for	Somogy	Somogy
HU-SS, Name for	Szekszárd	Szekszárd
HU-ST, Name for	Salgótarján	Salgótarján
HU-SZ, Name for	Szabolcs-Szatmár-Bereg	Szabolcs-Szatmár-Bereg
HU-TB, Name for	Tatabánya	Tatabánya
HU-TO, Name for	Tolna	Tolna
HU-VA, Name for	Vas	Vas
HU-VE, Name for	Veszprém	Veszprém
HU-VM, Name for	Veszprém	Veszprém
HU-ZA, Name for	Zala	Zala
HU-ZE, Name for	Zalaegerszeg	Zalaegerszeg
ID-AC, Name for	Aceh	Aceh
ID-BA, Name for	Bali	Bali
ID-BB, Name for	Kepulauan Bangka Belitung	Bangka-Belitung
ID-BE, Name for	Bengkulu	Bengkulu
ID-BT, Name for	Banten	Banten
ID-GO, Name for	Gorontalo	Gorontalo
ID-JA, Name for	Jambi	Jambi
ID-JB, Name for	Jawa Barat	West-Java
ID-JI, Name for	Jawa Timur	Oost-Java
ID-JK, Name for	Jakarta Raya	Groot-Jakarta
ID-JT, Name for	Jawa Tengah	Midden-Java
ID-JW, Name for	Jawa	Java
ID-KA, Name for	Kalimantan	Kalimantan
ID-KB, Name for	Kalimantan Barat	West-Kalimantan
ID-KI, Name for	Kalimantan Timur	Oost-Kalimantan
ID-KR, Name for	Kepulauan Riau	Riau-eilanden
ID-KS, Name for	Kalimantan Selatan	Zuid-Kalimantan
ID-KT, Name for	Kalimantan Tengah	Centraal-Kalimantan
ID-KU, Name for	Kalimantan Utara	Noord-Kalimantan
ID-LA, Name for	Lampung	Lampung
ID-MA, Name for	Maluku	Molukken
ID-ML, Name for	Maluku	Molukken
ID-MU, Name for	Maluku Utara	Noord-Molukken
ID-NB, Name for	Nusa Tenggara Barat	West-Nusa Tenggara
ID-NT, Name for	Nusa Tenggara Timur	Oost-Nusa Tenggara
ID-NU, Name for	Nusa Tenggara	Nusa Tenggara
ID-PA, Name for	Papua	Papoea
ID-PB, Name for	Papua Barat	West-Papua
ID-PP, Name for	Papua	Papoea
ID-RI, Name for	Riau	Riau
ID-SA, Name for	Sulawesi Utara	Noord-Sulawesi
ID-SB, Name for	Sumatera Barat	West-Sumatra
ID-SG, Name for	Sulawesi Tenggara	Zuidoost-Sulawesi
ID-SL, Name for	Sulawesi	Sulawesi
ID-SM, Name for	Sumatera	Sumatra
ID-SN, Name for	Sulawesi Selatan	Zuid-Sulawesi
ID-SR, Name for	Sulawesi Barat	West-Sulawesi
ID-SS, Name for	Sumatera Selatan	Zuid-Sumatra
ID-ST, Name for	Sulawesi Tengah	Centraal Sulawesi
ID-SU, Name for	Sumatera Utara	Noord-Sumatra
ID-YO, Name for	Yogyakarta	Yogyakarta
IE-C, Name for	Connaught	Connacht
IE-CE, Name for	Clare	Clare
IE-CN, Name for	Cavan	Cavan
IE-CO, Name for	Cork	Cork
IE-CW, Name for	Carlow	Carlow
IE-D, Name for	Dublin	Dublin
IE-DL, Name for	Donegal	Donegal
IE-G, Name for	Galway	Galway
IE-KE, Name for	Kildare	Kildare
IE-KK, Name for	Kilkenny	Kilkenny
IE-KY, Name for	Kerry	Kerry
IE-L, Name for	Leinster	Leinster
IE-LD, Name for	Longford	Longford
IE-LH, Name for	Louth	Louth
IE-LK, Name for	Limerick	Limerick
IE-LM, Name for	Leitrim	Leitrim
IE-LS, Name for	Laois	Laois
IE-M, Name for	Munster	Munster
IE-MH, Name for	Meath	Meath
IE-MN, Name for	Monaghan	Monaghan
IE-MO, Name for	Mayo	Mayo
IE-OY, Name for	Offaly	Offaly
IE-RN, Name for	Roscommon	Roscommon
IE-SO, Name for	Sligo	Sligo
IE-TA, Name for	Tipperary	Tipperary
IE-U, Name for	Ulster	Ulster
IE-WD, Name for	Waterford	Waterford
IE-WH, Name for	Westmeath	Westmeath
IE-WW, Name for	Wicklow	Wicklow
IE-WX, Name for	Wexford	Wexford
IL-D, Name for	Al Janūbī	Debub
IL-HA, Name for	H̱efa	Haifa
IL-JM, Name for	Al Quds	Al Kadisiah
IL-M, Name for	Al Awsaţ	Maekel
IL-TA, Name for	Tall Abīb	Tel Aviv
IL-Z, Name for	Ash Shamālī	Ash Shamallyah
IN-AN, Name for	Andaman and Nicobar Islands	Andaman- en Nicobar-eilanden
IN-AP, Name for	Andhra Pradesh	Andhra Pradesh
IN-AR, Name for	Arunāchal Pradesh	Arunachal Pradesh
IN-AS, Name for	Assam	Assam
IN-BR, Name for	Bihār	Bihar
IN-CH, Name for	Chandīgarh	Chandigarh
IN-CT, Name for	Chhattīsgarh	Chhattisgarh
IN-DH, Name for	Dādra and Nagar Haveli and Damān and Diu	Dadra en Nagar Haveli
IN-DL, Name for	Delhi	Delhi
IN-GA, Name for	Goa	Goa
IN-GJ, Name for	Gujarāt	Gujarat
IN-HP, Name for	Himāchal Pradesh	Himachal Pradesh
IN-HR, Name for	Haryāna	Haryana
IN-JH, Name for	Jhārkhand	Jharkhand
IN-JK, Name for	Jammu and Kashmīr	Jammu en Kashmir
IN-KA, Name for	Karnātaka	Karnataka
IN-KL, Name for	Kerala	Kerala
IN-LA, Name for	Ladākh	Ladakh
IN-LD, Name for	Lakshadweep	Lakshadweep
IN-MH, Name for	Mahārāshtra	Maharashtra
IN-ML, Name for	Meghālaya	Meghalaya
IN-MN, Name for	Manipur	Manipur
IN-MP, Name for	Madhya Pradesh	Madhya Pradesh
IN-MZ, Name for	Mizoram	Mizoram
IN-NL, Name for	Nāgāland	Nagaland
IN-OR, Name for	Odisha	Odisha
IN-PB, Name for	Punjab	Punjab
IN-PY, Name for	Puducherry	Puducherry
IN-RJ, Name for	Rājasthān	Rajasthan
IN-SK, Name for	Sikkim	Sikkim
IN-TG, Name for	Telangāna	Telangana
IN-TN, Name for	Tamil Nādu	Tamil Nadu
IN-TR, Name for	Tripura	Tripura
IN-UP, Name for	Uttar Pradesh	Uttar Pradesh
IN-UT, Name for	Uttarākhand	Uttarakhand
IN-WB, Name for	West Bengal	West-Bengalen
IQ-AN, Name for	Al Anbār	Al Anbar
IQ-AR, Name for	Arbīl	NOG NIET VERTAALD
IQ-BA, Name for	Al Başrah	Basra
IQ-BB, Name for	Bābil	NOG NIET VERTAALD
IQ-BG, Name for	Baghdād	Bagdad
IQ-DA, Name for	Dahūk	NOG NIET VERTAALD
IQ-DI, Name for	Diyālá	NOG NIET VERTAALD
IQ-DQ, Name for	Dhī Qār	NOG NIET VERTAALD
IQ-KA, Name for	Karbalā’	'Karbala
IQ-KI, Name for	Kirkūk	Kirkop
IQ-MA, Name for	Maysān	Maysan
IQ-MU, Name for	Al Muthanná	Al Muthanna
IQ-NA, Name for	An Najaf	Najaf
IQ-NI, Name for	Nīnawá	NOG NIET VERTAALD
IQ-QA, Name for	Al Qādisīyah	Al Kadisiah
IQ-SD, Name for	Şalāḩ ad Dīn	NOG NIET VERTAALD
IQ-SU, Name for	As Sulaymānīyah	As Sulaymaniyah
IQ-WA, Name for	Wāsiţ	NOG NIET VERTAALD
IR-00, Name for	Markazī	Markazi
IR-01, Name for	Gīlān	Gilan
IR-02, Name for	Māzandarān	Mazandaran
IR-03, Name for	Āz̄ārbāyjān-e Shārqī	Oost-Azerbeijan
IR-04, Name for	Āz̄ārbāyjān-e Ghārbī	West-Azerbeijan
IR-05, Name for	Kermānshāh	Kermanshah
IR-06, Name for	Khūzestān	Khoezistan
IR-07, Name for	Fārs	Fars
IR-08, Name for	Kermān	Kerman
IR-09, Name for	Khorāsān-e Raẕavī	Khorasan-e-Razavi
IR-10, Name for	Eşfahān	Isfahan
IR-11, Name for	Sīstān va Balūchestān	Sistan en Beloetsjistan
IR-12, Name for	Kordestān	Kordestan
IR-13, Name for	Hamadān	Hamadan
IR-14, Name for	Chahār Maḩāl va Bakhtīārī	Chahar Mahaal en Bakhtiari
IR-15, Name for	Lorestān	Lorestan
IR-16, Name for	Īlām	Ilam
IR-17, Name for	Kohgīlūyeh va Bowyer Aḩmad	Kohjiluyeh en Buyer Ahmad
IR-18, Name for	Būshehr	Bushehr
IR-19, Name for	Zanjān	Zanjan
IR-20, Name for	Semnān	Semnan
IR-21, Name for	Yazd	Yazd
IR-22, Name for	Hormozgān	Hormosgan
IR-23, Name for	Tehrān	Teheran
IR-24, Name for	Ardabīl	Ardebil
IR-25, Name for	Qom	Qom
IR-26, Name for	Qazvīn	Qazvin
IR-27, Name for	Golestān	Golestan
IR-28, Name for	Khorāsān-e Shomālī	Khorasan-e-shomali
IR-29, Name for	Khorāsān-e Jonūbī	Khorasan-e-Jonoobi
IR-30, Name for	Alborz	Elboers; Elburz; Alborz
IS-1, Name for	Höfuðborgarsvæði	Hoofdstedelijke Regio
IS-2, Name for	Suðurnes	Zuidelijk schiereiland
IS-3, Name for	Vesturland	Westland
IS-4, Name for	Vestfirðir	Westfjorden
IS-5, Name for	Norðurland vestra	Noordland west
IS-6, Name for	Norðurland eystra	Noordland oost
IS-7, Name for	Austurland	Oostland
IS-8, Name for	Suðurland	Zuidland
IS-AKH, Name for	Akrahreppur	NOG NIET VERTAALD
IS-AKN, Name for	Akraneskaupstaður	NOG NIET VERTAALD
IS-AKU, Name for	Akureyrarbær	NOG NIET VERTAALD
IS-ARN, Name for	Árneshreppur	NOG NIET VERTAALD
IS-ASA, Name for	Ásahreppur	NOG NIET VERTAALD
IS-BFJ, Name for	Borgarfjarðarhreppur	NOG NIET VERTAALD
IS-BLA, Name for	Bláskógabyggð	NOG NIET VERTAALD
IS-BLO, Name for	Blönduósbær	NOG NIET VERTAALD
IS-BOG, Name for	Borgarbyggð	NOG NIET VERTAALD
IS-BOL, Name for	Bolungarvíkurkaupstaður	NOG NIET VERTAALD
IS-DAB, Name for	Dalabyggð	Dalaba
IS-DAV, Name for	Dalvíkurbyggð	NOG NIET VERTAALD
IS-DJU, Name for	Djúpavogshreppur	NOG NIET VERTAALD
IS-EOM, Name for	Eyja- og Miklaholtshreppur	NOG NIET VERTAALD
IS-EYF, Name for	Eyjafjarðarsveit	NOG NIET VERTAALD
IS-FJD, Name for	Fjarðabyggð	NOG NIET VERTAALD
IS-FJL, Name for	Fjallabyggð	NOG NIET VERTAALD
IS-FLA, Name for	Flóahreppur	NOG NIET VERTAALD
IS-FLD, Name for	Fljótsdalshérað	NOG NIET VERTAALD
IS-FLR, Name for	Fljótsdalshreppur	NOG NIET VERTAALD
IS-GAR, Name for	Garðabær	NOG NIET VERTAALD
IS-GOG, Name for	Grímsnes- og Grafningshreppur	NOG NIET VERTAALD
IS-GRN, Name for	Grindavíkurbær	NOG NIET VERTAALD
IS-GRU, Name for	Grundarfjarðarbær	NOG NIET VERTAALD
IS-GRY, Name for	Grýtubakkahreppur	NOG NIET VERTAALD
IS-HAF, Name for	Hafnarfjarðarkaupstaður	NOG NIET VERTAALD
IS-HEL, Name for	Helgafellssveit	NOG NIET VERTAALD
IS-HRG, Name for	Hörgársveit	NOG NIET VERTAALD
IS-HRU, Name for	Hrunamannahreppur	NOG NIET VERTAALD
IS-HUT, Name for	Húnavatnshreppur	NOG NIET VERTAALD
IS-HUV, Name for	Húnaþing vestra	NOG NIET VERTAALD
IS-HVA, Name for	Hvalfjarðarsveit	NOG NIET VERTAALD
IS-HVE, Name for	Hveragerðisbær	NOG NIET VERTAALD
IS-ISA, Name for	Ísafjarðarbær	NOG NIET VERTAALD
IS-KAL, Name for	Kaldrananeshreppur	NOG NIET VERTAALD
IS-KJO, Name for	Kjósarhreppur	NOG NIET VERTAALD
IS-KOP, Name for	Kópavogsbær	NOG NIET VERTAALD
IS-LAN, Name for	Langanesbyggð	NOG NIET VERTAALD
IS-MOS, Name for	Mosfellsbær	NOG NIET VERTAALD
IS-MYR, Name for	Mýrdalshreppur	NOG NIET VERTAALD
IS-NOR, Name for	Norðurþing	NOG NIET VERTAALD
IS-RGE, Name for	Rangárþing eystra	NOG NIET VERTAALD
IS-RGY, Name for	Rangárþing ytra	NOG NIET VERTAALD
IS-RHH, Name for	Reykhólahreppur	NOG NIET VERTAALD
IS-RKN, Name for	Reykjanesbær	Reykjavik
IS-RKV, Name for	Reykjavíkurborg	Reykjavik
IS-SBH, Name for	Svalbarðshreppur	NOG NIET VERTAALD
IS-SBT, Name for	Svalbarðsstrandarhreppur	NOG NIET VERTAALD
IS-SDN, Name for	Suðurnesjabær	Zuidelijk schiereiland
IS-SDV, Name for	Súðavíkurhreppur	NOG NIET VERTAALD
IS-SEL, Name for	Seltjarnarnesbær	NOG NIET VERTAALD
IS-SEY, Name for	Seyðisfjarðarkaupstaður	NOG NIET VERTAALD
IS-SFA, Name for	Sveitarfélagið Árborg	NOG NIET VERTAALD
IS-SHF, Name for	Sveitarfélagið Hornafjörður	NOG NIET VERTAALD
IS-SKF, Name for	Skaftárhreppur	NOG NIET VERTAALD
IS-SKG, Name for	Skagabyggð	NOG NIET VERTAALD
IS-SKO, Name for	Skorradalshreppur	NOG NIET VERTAALD
IS-SKU, Name for	Skútustaðahreppur	NOG NIET VERTAALD
IS-SNF, Name for	Snæfellsbær	NOG NIET VERTAALD
IS-SOG, Name for	Skeiða- og Gnúpverjahreppur	NOG NIET VERTAALD
IS-SOL, Name for	Sveitarfélagið Ölfus	NOG NIET VERTAALD
IS-SSF, Name for	Sveitarfélagið Skagafjörður	NOG NIET VERTAALD
IS-SSS, Name for	Sveitarfélagið Skagaströnd	NOG NIET VERTAALD
IS-STR, Name for	Strandabyggð	NOG NIET VERTAALD
IS-STY, Name for	Stykkishólmsbær	NOG NIET VERTAALD
IS-SVG, Name for	Sveitarfélagið Vogar	NOG NIET VERTAALD
IS-TAL, Name for	Tálknafjarðarhreppur	NOG NIET VERTAALD
IS-THG, Name for	Þingeyjarsveit	NOG NIET VERTAALD
IS-TJO, Name for	Tjörneshreppur	NOG NIET VERTAALD
IS-VEM, Name for	Vestmannaeyjabær	NOG NIET VERTAALD
IS-VER, Name for	Vesturbyggð	Westfjorden
IS-VOP, Name for	Vopnafjarðarhreppur	NOG NIET VERTAALD
IT-21, Name for	Piemonte	Piëmont
IT-23, Name for	Val d'Aoste	Aostadal
IT-25, Name for	Lombardia	Lombardije
IT-32, Name for	Trentino-Alto Adige	Trentino-Zuid-Tirol
IT-34, Name for	Veneto	Veneto
IT-36, Name for	Friuli Venezia Giulia	Friuli-Julisch Venetië
IT-42, Name for	Liguria	Ligurië
IT-45, Name for	Emilia-Romagna	Emilia-Romagna
IT-52, Name for	Toscana	Toscane
IT-55, Name for	Umbria	Umbrië
IT-57, Name for	Marche	Marken
IT-62, Name for	Lazio	Latium
IT-65, Name for	Abruzzo	Abruzzen
IT-67, Name for	Molise	Molise
IT-72, Name for	Campania	Campanië
IT-75, Name for	Puglia	Apulië
IT-77, Name for	Basilicata	Basilicata
IT-78, Name for	Calabria	Calabrië
IT-82, Name for	Sicilia	Sicilië
IT-88, Name for	Sardegna	Sardinië
IT-AG, Name for	Agrigento	Agrigento
IT-AL, Name for	Alessandria	Alessandria
IT-AN, Name for	Ancona	Ancona
IT-AP, Name for	Ascoli Piceno	Ascoli Piceno
IT-AQ, Name for	L'Aquila	L'Aquila
IT-AR, Name for	Arezzo	Arezzo
IT-AT, Name for	Asti	Asti
IT-AV, Name for	Avellino	Avellino
IT-BA, Name for	Bari	Bari
IT-BG, Name for	Bergamo	Bergamo
IT-BI, Name for	Biella	Biella
IT-BL, Name for	Belluno	Belluno
IT-BN, Name for	Benevento	Benevento
IT-BO, Name for	Bologna	Bologna
IT-BR, Name for	Brindisi	Brindisi
IT-BS, Name for	Brescia	Brescia
IT-BT, Name for	Barletta-Andria-Trani	Barletta-Andria-Trani
IT-BZ, Name for	Bolzano	Bolzano
IT-CA, Name for	Cagliari	Cagliari
IT-CB, Name for	Campobasso	Campobasso
IT-CE, Name for	Caserta	Caserta
IT-CH, Name for	Chieti	Chieti
IT-CL, Name for	Caltanissetta	Caltanissetta
IT-CN, Name for	Cuneo	Cuneo
IT-CO, Name for	Como	Como
IT-CR, Name for	Cremona	Cremona
IT-CS, Name for	Cosenza	Cosenza
IT-CT, Name for	Catania	Catanië
IT-CZ, Name for	Catanzaro	Catanzaro
IT-EN, Name for	Enna	Enna
IT-FC, Name for	Forlì-Cesena	Forlì-Cesena
IT-FE, Name for	Ferrara	Ferrara
IT-FG, Name for	Foggia	Foggia
IT-FI, Name for	Firenze	Florence
IT-FM, Name for	Fermo	Fermo
IT-FR, Name for	Frosinone	Frosinone
IT-GE, Name for	Genova	Genua
IT-GO, Name for	Gorizia	Gorizia
IT-GR, Name for	Grosseto	Grosseto
IT-IM, Name for	Imperia	Imperia
IT-IS, Name for	Isernia	Isernia
IT-KR, Name for	Crotone	Crotone
IT-LC, Name for	Lecco	Lecco
IT-LE, Name for	Lecce	Lecce
IT-LI, Name for	Livorno	Livorno
IT-LO, Name for	Lodi	Lodi
IT-LT, Name for	Latina	Latina
IT-LU, Name for	Lucca	Lucca
IT-MB, Name for	Monza e Brianza	Monza e Brianza
IT-MC, Name for	Macerata	Macerata
IT-ME, Name for	Messina	Messina
IT-MI, Name for	Milano	Milaan
IT-MN, Name for	Mantova	Mantova
IT-MO, Name for	Modena	Modena
IT-MS, Name for	Massa-Carrara	Massa-Carrara
IT-MT, Name for	Matera	Matera
IT-NA, Name for	Napoli	Napels
IT-NO, Name for	Novara	Novara
IT-NU, Name for	Nuoro	Nuoro
IT-OR, Name for	Oristano	Oristano
IT-PA, Name for	Palermo	Palermo
IT-PC, Name for	Piacenza	Piacenza
IT-PD, Name for	Padova	Padova
IT-PE, Name for	Pescara	Pescara
IT-PG, Name for	Perugia	Perugia
IT-PI, Name for	Pisa	Pisa
IT-PN, Name for	Pordenone	Pordenone
IT-PO, Name for	Prato	Prato
IT-PR, Name for	Parma	Parma
IT-PT, Name for	Pistoia	Pistoia
IT-PU, Name for	Pesaro e Urbino	Pesaro en Urbino
IT-PV, Name for	Pavia	Pavia
IT-PZ, Name for	Potenza	Potenza
IT-RA, Name for	Ravenna	Ravenna
IT-RC, Name for	Reggio Calabria	Calabrië, Regio
IT-RE, Name for	Reggio Emilia	Emilië, Regio
IT-RG, Name for	Ragusa	Ragusa
IT-RI, Name for	Rieti	Rieti
IT-RM, Name for	Roma	Rome
IT-RN, Name for	Rimini	Rimini
IT-RO, Name for	Rovigo	Rovigo
IT-SA, Name for	Salerno	Salerno
IT-SI, Name for	Siena	Siena
IT-SO, Name for	Sondrio	Sondrio
IT-SP, Name for	La Spezia	La Spezia
IT-SR, Name for	Siracusa	Siracuse
IT-SS, Name for	Sassari	Sassari
IT-SU, Name for	Sud Sardegna	Zuid-Sardinië
IT-SV, Name for	Savona	Savona
IT-TA, Name for	Taranto	Taranto
IT-TE, Name for	Teramo	Teramo
IT-TN, Name for	Trento	Trento
IT-TO, Name for	Torino	Turijn
IT-TP, Name for	Trapani	Trapani
IT-TR, Name for	Terni	Terni
IT-TS, Name for	Trieste	Triëst
IT-TV, Name for	Treviso	Treviso
IT-UD, Name for	Udine	Udine
IT-VA, Name for	Varese	Varese
IT-VB, Name for	Verbano-Cusio-Ossola	Verbano-Cusio-Ossola
IT-VC, Name for	Vercelli	Vercelli
IT-VE, Name for	Venezia	Venetië
IT-VI, Name for	Vicenza	Vicenza
IT-VR, Name for	Verona	Verona
IT-VT, Name for	Viterbo	Viterbo
IT-VV, Name for	Vibo Valentia	Vibo Valentia
JM-01, Name for	Kingston	Kingston
JM-02, Name for	Saint Andrew	Saint Andrew
JM-03, Name for	Saint Thomas	Saint Thomas
JM-04, Name for	Portland	Portland
JM-05, Name for	Saint Mary	Saint Mary
JM-06, Name for	Saint Ann	Saint Ann
JM-07, Name for	Trelawny	Trelawny
JM-08, Name for	Saint James	Saint James
JM-09, Name for	Hanover	Hanover
JM-10, Name for	Westmoreland	Westmoreland
JM-11, Name for	Saint Elizabeth	Saint Elizabeth
JM-12, Name for	Manchester	Manchester
JM-13, Name for	Clarendon	Clarendon
JM-14, Name for	Saint Catherine	Saint Catherine
JO-AJ, Name for	‘Ajlūn	Ajlun
JO-AM, Name for	Al ‘A̅şimah	Akaba
JO-AQ, Name for	Al ‘Aqabah	Akaba
JO-AT, Name for	Aţ Ţafīlah	Tafilah
JO-AZ, Name for	Az Zarqā’	Zarka
JO-BA, Name for	Al Balqā’	Balka
JO-IR, Name for	Irbid	Irbid
JO-JA, Name for	Jarash	Jerash
JO-KA, Name for	Al Karak	Kerak
JO-MA, Name for	Al Mafraq	Mafrak
JO-MD, Name for	Mādabā	Madaba
JO-MN, Name for	Ma‘ān	Ma'an
JP-01, Name for	Hokkaido	Hokkaido
JP-02, Name for	Aomori	Aomori
JP-03, Name for	Iwate	Iwate
JP-04, Name for	Miyagi	Miyagi
JP-05, Name for	Akita	Akita
JP-06, Name for	Yamagata	Yamagata
JP-07, Name for	Fukushima	Fukushima
JP-08, Name for	Ibaraki	Ibaraki
JP-09, Name for	Tochigi	Tochigi
JP-10, Name for	Gunma	Gunma
JP-11, Name for	Saitama	Saitama
JP-12, Name for	Chiba	Chiba
JP-13, Name for	Tokyo	Tokio; Tokyo
JP-14, Name for	Kanagawa	Kanagawa
JP-15, Name for	Niigata	Niigata
JP-16, Name for	Toyama	Toyama
JP-17, Name for	Ishikawa	Ishikawa
JP-18, Name for	Fukui	Fukui
JP-19, Name for	Yamanashi	Yamanashi
JP-20, Name for	Nagano	Nagano
JP-21, Name for	Gifu	Gifu
JP-22, Name for	Shizuoka	Shizuoka
JP-23, Name for	Aichi	Aichi
JP-24, Name for	Mie	Mie
JP-25, Name for	Shiga	Shiga
JP-26, Name for	Kyoto	Kioto; Kyoto
JP-27, Name for	Osaka	Osaka
JP-28, Name for	Hyogo	Hyogo
JP-29, Name for	Nara	Nara
JP-30, Name for	Wakayama	Wakayama
JP-31, Name for	Tottori	Tottori
JP-32, Name for	Shimane	Shimane
JP-33, Name for	Okayama	Okayama
JP-34, Name for	Hiroshima	Hiroshima
JP-35, Name for	Yamaguchi	Yamaguchi
JP-36, Name for	Tokushima	Tokushima
JP-37, Name for	Kagawa	Kagawa
JP-38, Name for	Ehime	Ehime
JP-39, Name for	Kochi	Kochi
JP-40, Name for	Fukuoka	Fukuoka
JP-41, Name for	Saga	Saga
JP-42, Name for	Nagasaki	Nagasaki
JP-43, Name for	Kumamoto	Kumamoto
JP-44, Name for	Oita	Oita
JP-45, Name for	Miyazaki	Miyazaki
JP-46, Name for	Kagoshima	Kagoshima
JP-47, Name for	Okinawa	Okinawa
KE-01, Name for	Baringo	Baringo
KE-02, Name for	Bomet	Bomet
KE-03, Name for	Bungoma	Bungoma
KE-04, Name for	Busia	Busia
KE-05, Name for	Elgeyo/Marakwet	Elgeyo-Marakwet
KE-06, Name for	Embu	Embu
KE-07, Name for	Garissa	Garissa
KE-08, Name for	Homa Bay	Homa Bay
KE-09, Name for	Isiolo	Isiolo
KE-10, Name for	Kajiado	Kajiado
KE-11, Name for	Kakamega	Kakamega
KE-12, Name for	Kericho	Kericho
KE-13, Name for	Kiambu	Kiambu
KE-14, Name for	Kilifi	Kilifi
KE-15, Name for	Kirinyaga	Kirinyaga
KE-16, Name for	Kisii	Kisii
KE-17, Name for	Kisumu	Kisumu
KE-18, Name for	Kitui	Kitui
KE-19, Name for	Kwale	Kwale
KE-20, Name for	Laikipia	Laikipia
KE-21, Name for	Lamu	Lamu
KE-22, Name for	Machakos	Machakos
KE-23, Name for	Makueni	Makueni
KE-24, Name for	Mandera	Mandera
KE-25, Name for	Marsabit	Marsabit
KE-26, Name for	Meru	Meru
KE-27, Name for	Migori	Migori
KE-28, Name for	Mombasa	Mombasa
KE-29, Name for	Murang'a	Murang'a
KE-30, Name for	Nairobi City	Nairobi County
KE-31, Name for	Nakuru	Nakuru
KE-32, Name for	Nandi	Nandi
KE-33, Name for	Narok	Narok
KE-34, Name for	Nyamira	Nyamira
KE-35, Name for	Nyandarua	Nyandarua
KE-36, Name for	Nyeri	Nyeri
KE-37, Name for	Samburu	Samburu
KE-38, Name for	Siaya	Siaya
KE-39, Name for	Taita/Taveta	Taveta
KE-40, Name for	Tana River	Tana River
KE-41, Name for	Tharaka-Nithi	Tharaka-Nithi
KE-42, Name for	Trans Nzoia	Trans-Nzoia
KE-43, Name for	Turkana	Turkana
KE-44, Name for	Uasin Gishu	Uasin Gishu
KE-45, Name for	Vihiga	Vihiga
KE-46, Name for	Wajir	Wajir
KE-47, Name for	West Pokot	West-Pokot
KG-B, Name for	Batken	Batken, Provincie
KG-C, Name for	Chuyskaya oblast'	Tsjoej, Provincie
KG-GB, Name for	Bishkek Shaary	Bisjkek
KG-GO, Name for	Gorod Osh	Oš (stad)
KG-J, Name for	Dzhalal-Abadskaya oblast'	Dzjalal-Abad, Provincie
KG-N, Name for	Naryn	Naryn, Provincie
KG-O, Name for	Osh	Oš, Provincie
KG-T, Name for	Talas	Talas, Provincie
KG-Y, Name for	Issyk-Kul'skaja oblast'	Ysykköl, Provincie
KH-1, Name for	Banteay Mean Choăy	Banteay Mean Cheay
KH-10, Name for	Kracheh	Kracheh
KH-11, Name for	Mondol Kiri	Mondol Kiri
KH-12, Name for	Phnom Penh	Phnom-Penh, Stedelijk Gewest
KH-13, Name for	Preah Vihear	Preah Vihear
KH-14, Name for	Prey Veaeng	Prey Veng
KH-15, Name for	Pousaat	Pouthisat
KH-16, Name for	Rotanak Kiri	Ratanakiri
KH-17, Name for	Siem Reab	Siem Reab
KH-18, Name for	Preah Sihanouk	Sihanoukville, Stedelijk Gewest
KH-19, Name for	Stoĕng Trêng	Stoeng Treng
KH-2, Name for	Baat Dambang	Battambang
KH-20, Name for	Svaay Rieng	Svay Rieng
KH-21, Name for	Taakaev	Takev
KH-22, Name for	Otdar Mean Chey	Oddar Meancheay
KH-23, Name for	Kaeb	Keb; Kaeb
KH-24, Name for	Pailin	Pailin, Stedelijk Gewest
KH-25, Name for	Tbong Khmum	Nong Khai
KH-3, Name for	Kampong Chaam	Kampong Cham
KH-4, Name for	Kampong Chhnang	Kampong Chhnang
KH-5, Name for	Kampong Spueu	Kampong Speu
KH-6, Name for	Kampong Thum	Kampong Thum
KH-7, Name for	Kampot	Kampot
KH-8, Name for	Kandaal	Kandal
KH-9, Name for	Kaoh Kong	Koh Kong
KI-G, Name for	Gilbert Islands	Gilbert-eilanden
KI-L, Name for	Line Islands	Line-eilanden
KI-P, Name for	Phoenix Islands	Phoenix-eilanden
KM-A, Name for	Andjouân	Anjouan
KM-G, Name for	Andjazîdja	Grande Comore
KM-M, Name for	Mohéli	Mohéli
KN-01, Name for	Christ Church Nichola Town	Christ Church Nichola Town
KN-02, Name for	Saint Anne Sandy Point	Saint Anne Sandy Point
KN-03, Name for	Saint George Basseterre	Saint George Basseterre
KN-04, Name for	Saint George Gingerland	Saint George Gingerland
KN-05, Name for	Saint James Windward	Saint James Windward
KN-06, Name for	Saint John Capisterre	Saint John Capisterre
KN-07, Name for	Saint John Figtree	Saint John Figtree
KN-08, Name for	Saint Mary Cayon	Saint Mary Cayon
KN-09, Name for	Saint Paul Capisterre	Saint Paul Capisterre
KN-10, Name for	Saint Paul Charlestown	Saint Paul Charlestown
KN-11, Name for	Saint Peter Basseterre	Saint Peter Basseterre
KN-12, Name for	Saint Thomas Lowland	Saint Thomas Lowland
KN-13, Name for	Saint Thomas Middle Island	Saint Thomas Middle Island
KN-15, Name for	Trinity Palmetto Point	Trinity Palmetto Point
KN-K, Name for	Saint Kitts	Saint Kitts
KN-N, Name for	Nevis	Nevis
KP-01, Name for	P'yǒngyang	Pyongyang
KP-02, Name for	P'yǒngan-namdo	Pyongyang-namdo
KP-03, Name for	P'yǒngan-bukto	Pyongyang-bukto
KP-04, Name for	Chagang-do	Chagang-do
KP-05, Name for	Hwanghae-namdo	Hwanghae-namdo
KP-06, Name for	Hwanghae-bukto	Hwanghae-bukto
KP-07, Name for	Kangweonto	Gangwon-do
KP-08, Name for	Hamgyǒng-namdo	Hamgyŏng-namdo
KP-09, Name for	Hamgyǒng-bukto	Hamgyŏng-bukto
KP-10, Name for	Ryanggang-do	Yanggang-do
KP-13, Name for	Raseon	Rason
KP-14, Name for	Nampho	Lamphun
KR-11, Name for	Seoul-teukbyeolsi	Seoul, Stadsgewest; Seoel, Stadsgewest
KR-26, Name for	Busan-gwangyeoksi	Busan Metropolitan City
KR-27, Name for	Daegu-gwangyeoksi	Daegu Metropolitan City
KR-28, Name for	Incheon-gwangyeoksi	Incheon Metropolitan City
KR-29, Name for	Gwangju-gwangyeoksi	Gwangju Metropolitan City
KR-30, Name for	Daejeon-gwangyeoksi	Daejeon Metropolitan City
KR-31, Name for	Ulsan-gwangyeoksi	Ulsan Metropolitan City
KR-41, Name for	Gyeonggi-do	Gyeonggi-do
KR-42, Name for	Gangwon-do	Gangwon-do
KR-43, Name for	Chungcheongbuk-do	Chungcheongbuk-do; Noord-Chungcheong
KR-44, Name for	Chungcheongnam-do	Chungcheongnam-do; Zuid-Chungcheong
KR-45, Name for	Jeollabuk-do	Jeollabuk-do; Noord-Jeolla
KR-46, Name for	Jeollanam-do	Jeollanam-do; Zuid-Jeolla
KR-47, Name for	Gyeongsangbuk-do	Gyeongsangbuk-do; Noord-Gyeongsang
KR-48, Name for	Gyeongsangnam-do	Gyeongsangnam-do; Zuid-Gyeongsang
KR-49, Name for	Jeju-teukbyeoljachido	Jeju-do; Jeju Eiland; Quelpaardseiland
KR-50, Name for	Sejong	Sejong
KW-AH, Name for	Al Aḩmadī	Ahmadi
KW-FA, Name for	Al Farwānīyah	Al Farwanlyah
KW-HA, Name for	Ḩawallī	Hawalli
KW-JA, Name for	Al Jahrā’	Jahra
KW-KU, Name for	Al ‘Āşimah	Al-Asimah
KW-MU, Name for	Mubārak al Kabīr	Mubarak Al-Kabier
KZ-AKM, Name for	Akmolinskaja oblast'	Aqmola, Provincie
KZ-AKT, Name for	Aktjubinskaja oblast'	Aqtöbe, Provincie
KZ-ALA, Name for	Almaty	Alma-Ata
KZ-ALM, Name for	Almatinskaja oblast'	Almaty, Provincie
KZ-AST, Name for	Nur-Sultan	Nur-Sultan
KZ-ATY, Name for	Atyrauskaja oblast'	Atıraw, Provincie
KZ-KAR, Name for	Karagandinskaja oblast'	Karaganda, Provincie
KZ-KUS, Name for	Kostanajskaja oblast'	Qostanay, Provincie
KZ-KZY, Name for	Kyzylordinskaja oblast'	Qızılorda, Provincie
KZ-MAN, Name for	Mangghystaū oblysy	Mañğıstaw, Provincie
KZ-PAV, Name for	Pavlodar oblysy	Pavlodar, Provincie
KZ-SEV, Name for	Severo-Kazahstanskaja oblast'	Noord-Kazachstan, Provincie
KZ-SHY, Name for	Shymkent	ŞımkentToshkent
KZ-VOS, Name for	Shyghys Qazaqstan oblysy	Oost-Kazachstan, Provincie
KZ-YUZ, Name for	Turkestankaya oblast'	Türkistan, Provincie
KZ-ZAP, Name for	Batys Qazaqstan oblysy	Batıs Qazaqstan, Provincie
KZ-ZHA, Name for	Zhambyl oblysy	Jambıl, Provincie
LA-AT, Name for	Attapu	Attapeu
LA-BK, Name for	Bokèo	Bokeo
LA-BL, Name for	Bolikhamxai	Bolikhamsai
LA-CH, Name for	Champasak	Champassak
LA-HO, Name for	Houaphan	Hua Phan
LA-KH, Name for	Khammouan	Khammuan
LA-LM, Name for	Louang Namtha	Luang Namtha
LA-LP, Name for	Louangphabang	Luang Prabang
LA-OU, Name for	Oudômxai	Udomxai
LA-PH, Name for	Phôngsali	Phongsali
LA-SL, Name for	Salavan	Salavan
LA-SV, Name for	Savannakhét	Savannakhet
LA-VI, Name for	Viangchan	Viangchan
LA-VT, Name for	Viangchan	Viangchan
LA-XA, Name for	Xaignabouli	Sainyabuli
LA-XE, Name for	Xékong	Sekong
LA-XI, Name for	Xiangkhouang	Xiangkhouang
LA-XS, Name for	Xaisômboun	Xaisômboun
LB-AK, Name for	Aakkâr	Akkar
LB-AS, Name for	Ash Shimāl	Ash Shamal
LB-BA, Name for	Bayrūt	Beiroet
LB-BH, Name for	Baalbek-Hermel	Baalbek-Hermel
LB-BI, Name for	Al Biqā‘	Balka
LB-JA, Name for	Al Janūb	Debub
LB-JL, Name for	Jabal Lubnān	Libanongebergte
LB-NA, Name for	An Nabaţīyah	Al Gharbiyah
LC-01, Name for	Anse la Raye	Anse Royale
LC-02, Name for	Castries	Castries
LC-03, Name for	Choiseul	Choiseul
LC-05, Name for	Dennery	Vienne
LC-06, Name for	Gros Islet	Grosseto
LC-07, Name for	Laborie	Tabor
LC-08, Name for	Micoud	Micoud
LC-10, Name for	Soufrière	Soufrière
LC-11, Name for	Vieux Fort	Vieux Fort
LC-12, Name for	Canaries	Canarische Eilanden
LI-01, Name for	Balzers	Balzers
LI-02, Name for	Eschen	Eschen
LI-03, Name for	Gamprin	Gamprin
LI-04, Name for	Mauren	Mauren
LI-05, Name for	Planken	Planken
LI-06, Name for	Ruggell	Ruggell
LI-07, Name for	Schaan	Schaan
LI-08, Name for	Schellenberg	Schellenberg
LI-09, Name for	Triesen	Triesen
LI-10, Name for	Triesenberg	Triesenberg
LI-11, Name for	Vaduz	Vaduz
LK-1, Name for	Western Province	Mountain Province
LK-11, Name for	Colombo	Colorado
LK-12, Name for	Gampaha	Gampaha
LK-13, Name for	Kalutara	Kaḷutara
LK-2, Name for	Central Province	Mountain Province
LK-21, Name for	Kandy	Kandal
LK-22, Name for	Matale	Matale
LK-23, Name for	Nuwara Eliya	Nuwara Eliya
LK-3, Name for	Southern Province	Mountain Province
LK-31, Name for	Galle	Valle
LK-32, Name for	Matara	Matara
LK-33, Name for	Hambantota	Hambantoṭa
LK-4, Name for	Northern Province	Mountain Province
LK-41, Name for	Jaffna	Jaffna
LK-42, Name for	Kilinochchi	Kilinochchi
LK-43, Name for	Mannar	Sannat
LK-44, Name for	Vavuniya	Vavuniya
LK-45, Name for	Mullaittivu	Mullaitivu
LK-5, Name for	Eastern Province	Mountain Province
LK-51, Name for	Batticaloa	Battambang
LK-52, Name for	Ampara	Ampara
LK-53, Name for	Trincomalee	Trincomalee
LK-6, Name for	North Western Province	Noord-West
LK-61, Name for	Kurunegala	Kurunegala
LK-62, Name for	Puttalam	Puttalam
LK-7, Name for	North Central Province	Midden-Noord
LK-71, Name for	Anuradhapura	Anuradhapura
LK-72, Name for	Polonnaruwa	Polonnaruwa
LK-8, Name for	Uva Province	Mountain Province
LK-81, Name for	Badulla	Badulla
LK-82, Name for	Monaragala	Matagalpa
LK-9, Name for	Sabaragamuwa Province	Sabaragamuwa
LK-91, Name for	Ratnapura	Ratnapura
LK-92, Name for	Kegalla	Kegalle
LR-BG, Name for	Bong	Bong
LR-BM, Name for	Bomi	Bomi
LR-CM, Name for	Grand Cape Mount	Grand Cape Mount
LR-GB, Name for	Grand Bassa	Grand Bassa
LR-GG, Name for	Grand Gedeh	Grand Gedeh
LR-GK, Name for	Grand Kru	Grand Kru
LR-GP, Name for	Gbarpolu	Gbarpolu
LR-LO, Name for	Lofa	Lofa
LR-MG, Name for	Margibi	Margibi
LR-MO, Name for	Montserrado	Montserrado
LR-MY, Name for	Maryland	Maryland
LR-NI, Name for	Nimba	Nimba
LR-RG, Name for	River Gee	River Cess
LR-RI, Name for	River Cess	River Cess
LR-SI, Name for	Sinoe	Sinoe
LS-A, Name for	Maseru	Maseru
LS-B, Name for	Botha-Bothe	Butha-Buthe
LS-C, Name for	Leribe	Leribe
LS-D, Name for	Berea	Berea
LS-E, Name for	Mafeteng	Mafeteng
LS-F, Name for	Mohale's Hoek	Mohale's Hoek
LS-G, Name for	Quthing	Quthing
LS-H, Name for	Qacha's Nek	Qacha's Nek
LS-J, Name for	Mokhotlong	Mokhotlong
LS-K, Name for	Thaba-Tseka	Thaba-Tseka
LT-01, Name for	Akmenė	Akmenė
LT-02, Name for	Alytaus miestas	Alytaus miestas
LT-03, Name for	Alytus	Alytus
LT-04, Name for	Anykščiai	NOG NIET VERTAALD
LT-05, Name for	Birštono	NOG NIET VERTAALD
LT-06, Name for	Biržai	NOG NIET VERTAALD
LT-07, Name for	Druskininkai	Druskininkai
LT-08, Name for	Elektrėnai	Elektrėnai
LT-09, Name for	Ignalina	Ignalina
LT-10, Name for	Jonava	Jonava
LT-11, Name for	Joniškis	NOG NIET VERTAALD
LT-12, Name for	Jurbarkas	Jurbarkas
LT-13, Name for	Kaišiadorys	NOG NIET VERTAALD
LT-14, Name for	Kalvarijos	NOG NIET VERTAALD
LT-15, Name for	Kauno miestas	Kauno miestas
LT-16, Name for	Kaunas	Kaunas
LT-17, Name for	Kazlų Rūdos	NOG NIET VERTAALD
LT-18, Name for	Kėdainiai	Kėdainiai
LT-19, Name for	Kelmė	Kelmė
LT-20, Name for	Klaipėdos miestas	NOG NIET VERTAALD
LT-21, Name for	Klaipėda	Klaipėda
LT-22, Name for	Kretinga	Kretinga
LT-23, Name for	Kupiškis	NOG NIET VERTAALD
LT-24, Name for	Lazdijai	Lazdijai
LT-25, Name for	Marijampolė	NOG NIET VERTAALD
LT-26, Name for	Mažeikiai	NOG NIET VERTAALD
LT-27, Name for	Molėtai	Molėtai
LT-28, Name for	Neringa	Neringa
LT-29, Name for	Pagėgiai	Pagėgiai
LT-30, Name for	Pakruojis	Pakruojis
LT-31, Name for	Palangos miestas	Palangos miestas
LT-32, Name for	Panevėžio miestas	NOG NIET VERTAALD
LT-33, Name for	Panevėžys	NOG NIET VERTAALD
LT-34, Name for	Pasvalys	Pasvalys
LT-35, Name for	Plungė	Plungė
LT-36, Name for	Prienai	Prienai
LT-37, Name for	Radviliškis	NOG NIET VERTAALD
LT-38, Name for	Raseiniai	Raseiniai
LT-39, Name for	Rietavo	Rietavo
LT-40, Name for	Rokiškis	NOG NIET VERTAALD
LT-41, Name for	Šakiai	NOG NIET VERTAALD
LT-42, Name for	Šalčininkai	NOG NIET VERTAALD
LT-43, Name for	Šiaulių miestas	NOG NIET VERTAALD
LT-44, Name for	Šiauliai	NOG NIET VERTAALD
LT-45, Name for	Šilalė	NOG NIET VERTAALD
LT-46, Name for	Šilutė	NOG NIET VERTAALD
LT-47, Name for	Širvintos	NOG NIET VERTAALD
LT-48, Name for	Skuodas	Skuodas
LT-49, Name for	Švenčionys	NOG NIET VERTAALD
LT-50, Name for	Tauragė	Tauragė
LT-51, Name for	Telšiai	NOG NIET VERTAALD
LT-52, Name for	Trakai	NOG NIET VERTAALD
LT-53, Name for	Ukmergė	NOG NIET VERTAALD
LT-54, Name for	Utena	Utena
LT-55, Name for	Varėna	NOG NIET VERTAALD
LT-56, Name for	Vilkaviškis	NOG NIET VERTAALD
LT-57, Name for	Vilniaus miestas	Vilniaus miestas
LT-58, Name for	Vilnius	Vilnius
LT-59, Name for	Visaginas	Visaginas
LT-60, Name for	Zarasai	Zarasai
LT-AL, Name for	Alytaus apskritis	Alytus (district)
LT-KL, Name for	Klaipėdos apskritis	NOG NIET VERTAALD
LT-KU, Name for	Kauno apskritis	Kaunas (district)
LT-MR, Name for	Marijampolės apskritis	Marijampolė (district)
LT-PN, Name for	Panevėžio apskritis	Panevėžys (district)
LT-SA, Name for	Šiaulių apskritis	Šiauliai (district)
LT-TA, Name for	Tauragės apskritis	NOG NIET VERTAALD
LT-TE, Name for	Telšių apskritis	Telšiai (district)
LT-UT, Name for	Utenos apskritis	Utena (district)
LT-VL, Name for	Vilniaus apskritis	Vilnius (district)
LU-CA, Name for	Capellen	Capellen
LU-CL, Name for	Clerf	Clervaux
LU-DI, Name for	Diekirch	Diekirch
LU-EC, Name for	Echternach	Echternach
LU-ES, Name for	Esch an der Alzette	Esch-sur-Alzette
LU-GR, Name for	Grevenmacher	Grevenmacher
LU-LU, Name for	Luxembourg	Luxemburg
LU-ME, Name for	Mersch	Mersch
LU-RD, Name for	Redange	Redange
LU-RM, Name for	Remich	Remich
LU-VD, Name for	Veianen	Vianden
LU-WI, Name for	Wiltz	Wiltz
LV-001, Name for	Aglonas novads	Aglona
LV-002, Name for	Aizkraukles novads	Aglona
LV-003, Name for	Aizputes novads	Aizpute
LV-004, Name for	Aknīstes novads	Aknīste
LV-005, Name for	Alojas novads	Aloja
LV-006, Name for	Alsungas novads	Alsunga
LV-007, Name for	Alūksnes novads	Alūksne
LV-008, Name for	Amatas novads	Amata
LV-009, Name for	Apes novads	Ape
LV-010, Name for	Auces novads	Auce
LV-011, Name for	Ādažu novads	Ādaži
LV-012, Name for	Babītes novads	Babīte
LV-013, Name for	Baldones novads	Baldone
LV-014, Name for	Baltinavas novads	Baltinava
LV-015, Name for	Balvu novads	Balvi
LV-016, Name for	Bauskas novads	Bauska
LV-017, Name for	Beverīnas novads	Beverīna
LV-018, Name for	Brocēnu novads	Brocēni
LV-019, Name for	Burtnieku novads	Burtnieki
LV-020, Name for	Carnikavas novads	Carnikava
LV-021, Name for	Cesvaines novads	Cesvaine
LV-022, Name for	Cēsu novads	Cēsis
LV-023, Name for	Ciblas novads	Cibla
LV-024, Name for	Dagdas novads	Dagda
LV-025, Name for	Daugavpils novads	Daugavpils
LV-026, Name for	Dobeles novads	Dobele
LV-027, Name for	Dundagas novads	Dundaga
LV-028, Name for	Durbes novads	Durbe
LV-029, Name for	Engures novads	Engure
LV-030, Name for	Ērgļu novads	Ērgļi
LV-031, Name for	Garkalnes novads	Garkalne
LV-032, Name for	Grobiņas novads	Grobiņa
LV-033, Name for	Gulbenes novads	Gulbene
LV-034, Name for	Iecavas novads	Iecava
LV-035, Name for	Ikšķiles novads	Ikšķile
LV-036, Name for	Ilūkstes novads	Ilūkste
LV-037, Name for	Inčukalna novads	Inčukalns
LV-038, Name for	Jaunjelgavas novads	Jaunjelgava
LV-039, Name for	Jaunpiebalgas novads	Jaunpiebalga
LV-040, Name for	Jaunpils novads	Jaunpils
LV-041, Name for	Jelgavas novads	Jelgava
LV-042, Name for	Jēkabpils novads	Jēkabpils
LV-043, Name for	Kandavas novads	Kandava
LV-044, Name for	Kārsavas novads	Kārsava
LV-045, Name for	Kocēnu novads	Kocēnu novads
LV-046, Name for	Kokneses novads	Koknese
LV-047, Name for	Krāslavas novads	Krāslava
LV-048, Name for	Krimuldas novads	Krimulda
LV-049, Name for	Krustpils novads	Krustpils
LV-050, Name for	Kuldīgas novads	Kuldīga
LV-051, Name for	Ķeguma novads	Ķegums
LV-052, Name for	Ķekavas novads	Ķekava
LV-053, Name for	Lielvārdes novads	Lielvārde
LV-054, Name for	Limbažu novads	Limbaži
LV-055, Name for	Līgatnes novads	Līgatne
LV-056, Name for	Līvānu novads	Līvāni
LV-057, Name for	Lubānas novads	Lubāna
LV-058, Name for	Ludzas novads	Ludza
LV-059, Name for	Madonas novads	Madona
LV-060, Name for	Mazsalacas novads	Mazsalaca
LV-061, Name for	Mālpils novads	Mālpils
LV-062, Name for	Mārupes novads	Mārupe
LV-063, Name for	Mērsraga novads	Mērsraga
LV-064, Name for	Naukšēnu novads	Naukšēni
LV-065, Name for	Neretas novads	Nereta
LV-066, Name for	Nīcas novads	Nīca
LV-067, Name for	Ogres novads	Ogre
LV-068, Name for	Olaines novads	Olaine
LV-069, Name for	Ozolnieku novads	Ozolnieki
LV-070, Name for	Pārgaujas novads	Pārgauja
LV-071, Name for	Pāvilostas novads	Pāvilosta
LV-072, Name for	Pļaviņu novads	Pļaviņas
LV-073, Name for	Preiļu novads	Preiļi
LV-074, Name for	Priekules novads	Priekule
LV-075, Name for	Priekuļu novads	Priekuļi
LV-076, Name for	Raunas novads	Rauna
LV-077, Name for	Rēzeknes novads	Rēzekne
LV-078, Name for	Riebiņu novads	Riebiņi
LV-079, Name for	Rojas novads	Roja
LV-080, Name for	Ropažu novads	Ropaži
LV-081, Name for	Rucavas novads	Rucava
LV-082, Name for	Rugāju novads	Rugāji
LV-083, Name for	Rundāles novads	Rundāle
LV-084, Name for	Rūjienas novads	Rūjiena
LV-085, Name for	Salas novads	Sala
LV-086, Name for	Salacgrīvas novads	Salacgrīva
LV-087, Name for	Salaspils novads	Salaspils
LV-088, Name for	Saldus novads	Saldus
LV-089, Name for	Saulkrastu novads	Saulkrasti
LV-090, Name for	Sējas novads	Sēja
LV-091, Name for	Siguldas novads	Sigulda
LV-092, Name for	Skrīveru novads	Skrīveri
LV-093, Name for	Skrundas novads	Skrunda
LV-094, Name for	Smiltenes novads	Smiltene
LV-095, Name for	Stopiņu novads	Stopiņi
LV-096, Name for	Strenču novads	Strenči
LV-097, Name for	Talsu novads	Talsi
LV-098, Name for	Tērvetes novads	Tērvete
LV-099, Name for	Tukuma novads	Tukums
LV-100, Name for	Vaiņodes novads	Vaiņode
LV-101, Name for	Valkas novads	Valka
LV-102, Name for	Varakļānu novads	Varakļāni
LV-103, Name for	Vārkavas novads	Vārkava
LV-104, Name for	Vecpiebalgas novads	Vecpiebalga
LV-105, Name for	Vecumnieku novads	Vecumnieki
LV-106, Name for	Ventspils novads	Ventspils
LV-107, Name for	Viesītes novads	Viesīte
LV-108, Name for	Viļakas novads	Viļaka
LV-109, Name for	Viļānu novads	Viļāni
LV-110, Name for	Zilupes novads	Zilupe
LV-DGV, Name for	Daugavpils	Daugavpils (stad)
LV-JEL, Name for	Jelgava	Jelgava (stad)
LV-JKB, Name for	Jēkabpils	Jēkabpils (stad)
LV-JUR, Name for	Jūrmala	Jūrmala
LV-LPX, Name for	Liepāja	Liepāja
LV-REZ, Name for	Rēzekne	Rēzekne (stad)
LV-RIX, Name for	Rīga	Riga
LV-VEN, Name for	Ventspils	Ventspils
LV-VMR, Name for	Valmiera	Valmiera
LY-BA, Name for	Banghāzī	Benghazi
LY-BU, Name for	Al Buţnān	Al Butnan
LY-DR, Name for	Darnah	Darnah
LY-GT, Name for	Ghāt	Ghat
LY-JA, Name for	Al Jabal al Akhḑar	Al Jabal al Akhdar
LY-JG, Name for	Al Jabal al Gharbī	Al Jabal al Gharbī
LY-JI, Name for	Al Jafārah	Al Jifarah
LY-JU, Name for	Al Jufrah	Al Jufrah
LY-KF, Name for	Al Kufrah	Al Kufrah
LY-MB, Name for	Al Marqab	Al Marqab
LY-MI, Name for	Mişrātah	Misratah
LY-MJ, Name for	Al Marj	Al Marj
LY-MQ, Name for	Murzuq	Murzuq
LY-NL, Name for	Nālūt	Nalut
LY-NQ, Name for	An Nuqāţ al Khams	An Nuqat al Khams
LY-SB, Name for	Sabhā	Sabha
LY-SR, Name for	Surt	Surt
LY-TB, Name for	Ţarābulus	Tarabulus
LY-WA, Name for	Al Wāḩāt	Al Wahat
LY-WD, Name for	Wādī al Ḩayāt	Wadi al Hayat
LY-WS, Name for	Wādī ash Shāţi’	Wadi Ash Shati'
LY-ZA, Name for	Az Zāwiyah	Az Zawiyah
MA-01, Name for	Tanger-Tétouan-Al Hoceïma	Tanger-Tétouan-Al Hoceïma
MA-02, Name for	L'Oriental	Oriental
MA-03, Name for	Fès-Meknès	Fès-Meknès
MA-04, Name for	Rabat-Salé-Kénitra	Rabat-Salé-Kénitra
MA-05, Name for	Béni Mellal-Khénifra	Béni Mellal-Khénifra
MA-06, Name for	Casablanca-Settat	Casablanca-Settat
MA-07, Name for	Marrakech-Safi	Marrakech-Safi
MA-08, Name for	Drâa-Tafilalet	Drâa-Tafilalet
MA-09, Name for	Souss-Massa	Souss-Massa
MA-10, Name for	Guelmim-Oued Noun (EH-partial)	Guelmim-Oued Noun (EH-gedeeltelijk)
MA-11, Name for	Laâyoune-Sakia El Hamra (EH-partial)	Laâyoune-Sakia El Hamra (EH-gedeeltelijk)
MA-12, Name for	Dakhla-Oued Ed-Dahab (EH)	Dakhla-Oued ed Dahab (EH)
MA-AGD, Name for	Agadir-Ida-Ou-Tanane	Agadir-Ida-Ou-Tanane
MA-AOU, Name for	Aousserd (EH)	Aousserd (EH)
MA-ASZ, Name for	Assa-Zag (EH-partial)	Assa-Zag (EH-gedeeltelijk)
MA-AZI, Name for	Azilal	Azilal
MA-BEM, Name for	Béni Mellal	Béni Mellal
MA-BER, Name for	Berkane	Berkane
MA-BES, Name for	Benslimane	Benslimane
MA-BOD, Name for	Boujdour (EH)	Boujdour (EH)
MA-BOM, Name for	Boulemane	Boulemane
MA-BRR, Name for	Berrechid	Errachidia
MA-CAS, Name for	Casablanca	Casablanca
MA-CHE, Name for	Chefchaouen	Chefchaouen
MA-CHI, Name for	Chichaoua	Chichaoua
MA-CHT, Name for	Chtouka-Ait Baha	Chtouka-Ait Baha
MA-DRI, Name for	Driouch	Driouch
MA-ERR, Name for	Errachidia	Errachidia
MA-ESI, Name for	Essaouira	Essaouira
MA-ESM, Name for	Es-Semara (EH-partial)	Es-Smara (EH-gedeeltelijk)
MA-FAH, Name for	Fahs-Anjra	Fahs-Anjra
MA-FES, Name for	Fès	Fès
MA-FIG, Name for	Figuig	Figuig
MA-FQH, Name for	Fquih Ben Salah	Fquih Ben Salah
MA-GUE, Name for	Guelmim	Guelmim
MA-GUF, Name for	Guercif	Guercif
MA-HAJ, Name for	El Hajeb	El Hajeb
MA-HAO, Name for	Al Haouz	Al Haouz
MA-HOC, Name for	Al Hoceïma	Al Hoceïma
MA-IFR, Name for	Ifrane	Ifrane
MA-INE, Name for	Inezgane-Ait Melloul	Inezgane-Ait Melloul
MA-JDI, Name for	El Jadida	El Jadida
MA-JRA, Name for	Jerada	Jerada
MA-KEN, Name for	Kénitra	Kénitra
MA-KES, Name for	El Kelâa des Sraghna	El Kelâa des Sraghna
MA-KHE, Name for	Khémisset	Khemisset
MA-KHN, Name for	Khénifra	Khenifra
MA-KHO, Name for	Khouribga	Khouribga
MA-LAA, Name for	Laâyoune (EH)	Laâyoune (EH)
MA-LAR, Name for	Larache	Larache
MA-MAR, Name for	Marrakech	Marrakech
MA-MDF, Name for	M’diq-Fnideq	M'diq-Fnideq
MA-MED, Name for	Médiouna	Médiouna
MA-MEK, Name for	Meknès	Meknès
MA-MID, Name for	Midelt	Midelt
MA-MOH, Name for	Mohammadia	Mohammedia
MA-MOU, Name for	Moulay Yacoub	Moulay Yacoub
MA-NAD, Name for	Nador	Nador
MA-NOU, Name for	Nouaceur	Nouaceur
MA-OUA, Name for	Ouarzazate	Ouarzazate
MA-OUD, Name for	Oued Ed-Dahab (EH)	Oued ed Dahab (EH)
MA-OUJ, Name for	Oujda-Angad	Oujda-Angad
MA-OUZ, Name for	Ouezzane	Ouezzane
MA-RAB, Name for	Rabat	Rabat
MA-REH, Name for	Rehamna	Rehamna
MA-SAF, Name for	Safi	Safi
MA-SAL, Name for	Salé	Salé
MA-SEF, Name for	Sefrou	Sefrou
MA-SET, Name for	Settat	Settat
MA-SIB, Name for	Sidi Bennour	Sidi Bennour
MA-SIF, Name for	Sidi Ifni	Sidi Ifni
MA-SIK, Name for	Sidi Kacem	Sidi Kacem
MA-SIL, Name for	Sidi Slimane	Sidi Slimane
MA-SKH, Name for	Skhirate-Témara	Skhirate-Témara
MA-TAF, Name for	Tarfaya (EH-partial)	Tarfaya (EH-gedeeltelijk)
MA-TAI, Name for	Taourirt	Taourirt
MA-TAO, Name for	Taounate	Taounate
MA-TAR, Name for	Taroudannt	Taroudant
MA-TAT, Name for	Tata	Tata
MA-TAZ, Name for	Taza	Taza
MA-TET, Name for	Tétouan	Tétouan
MA-TIN, Name for	Tinghir	Tinghir
MA-TIZ, Name for	Tiznit	Tiznit
MA-TNG, Name for	Tanger-Assilah	Tanger-Assilah
MA-TNT, Name for	Tan-Tan (EH-partial)	Tan-Tan (EH-gedeeltelijk)
MA-YUS, Name for	Youssoufia	Youssoufia
MA-ZAG, Name for	Zagora	Zagora
MC-CL, Name for	La Colle	La Colle
MC-CO, Name for	La Condamine	La Condamine
MC-FO, Name for	Fontvieille	Fontvieille
MC-GA, Name for	La Gare	La Gare
MC-JE, Name for	Jardin Exotique	Jardin Exotique
MC-LA, Name for	Larvotto	Larvotto
MC-MA, Name for	Malbousquet	Malbousquet
MC-MC, Name for	Monte-Carlo	Monte-Carlo
MC-MG, Name for	Moneghetti	Moneghetti
MC-MO, Name for	Monaco-Ville	Monaco-Stad
MC-MU, Name for	Moulins	Moulins
MC-PH, Name for	Port-Hercule	Port-Hercule
MC-SD, Name for	Sainte-Dévote	Sainte-Dévote
MC-SO, Name for	La Source	La Source
MC-SP, Name for	Spélugues	Spélugues
MC-SR, Name for	Saint-Roman	Saint-Roman
MC-VR, Name for	Vallon de la Rousse	Vallon de la Rousse
MD-AN, Name for	Anenii Noi	Anenii Noi
MD-BA, Name for	Bălți	Bălți
MD-BD, Name for	Bender [Tighina]	Bender
MD-BR, Name for	Briceni	Briceni
MD-BS, Name for	Basarabeasca	Basarabeasca
MD-CA, Name for	Cahul	Cahul
MD-CL, Name for	Călărași	Călărași
MD-CM, Name for	Cimișlia	Cimișlia
MD-CR, Name for	Criuleni	Criuleni
MD-CS, Name for	Căușeni	Căușeni
MD-CT, Name for	Cantemir	Cantemir
MD-CU, Name for	Chișinău	Chișinău
MD-DO, Name for	Dondușeni	Dondușeni
MD-DR, Name for	Drochia	Drochia
MD-DU, Name for	Dubăsari	Dubăsari
MD-ED, Name for	Edineț	Edineț
MD-FA, Name for	Fălești	Fălești
MD-FL, Name for	Florești	Florești
MD-GA, Name for	Găgăuzia, Unitatea teritorială autonomă (UTAG)	Gagaoezië, Autonome Territoriale Eenheid; UTAG
MD-GL, Name for	Glodeni	Glodeni
MD-HI, Name for	Hîncești	Hîncești
MD-IA, Name for	Ialoveni	Ialoveni
MD-LE, Name for	Leova	Leova
MD-NI, Name for	Nisporeni	Nisporeni
MD-OC, Name for	Ocnița	Ocnița
MD-OR, Name for	Orhei	Orhei
MD-RE, Name for	Rezina	Rezina
MD-RI, Name for	Rîșcani	Rîșcani
MD-SD, Name for	Șoldănești	Șoldănești
MD-SI, Name for	Sîngerei	Sîngerei
MD-SN, Name for	Stînga Nistrului, unitatea teritorială din	Transnistrië, Territoriale Eenheid
MD-SO, Name for	Soroca	Soroca
MD-ST, Name for	Strășeni	Strășeni
MD-SV, Name for	Ștefan Vodă	Ștefan Vodă
MD-TA, Name for	Taraclia	Taraclia
MD-TE, Name for	Telenești	Telenești
MD-UN, Name for	Ungheni	Ungheni
ME-01, Name for	Andrijevica	Andrijavica
ME-02, Name for	Bar	Bar
ME-03, Name for	Berane	Berane
ME-04, Name for	Bijelo Polje	Bijelo Polje
ME-05, Name for	Budva	Budva
ME-06, Name for	Cetinje	Cetinje
ME-07, Name for	Danilovgrad	Danilovgrad
ME-08, Name for	Herceg-Novi	Herceg-Novi
ME-09, Name for	Kolašin	Kolašin
ME-10, Name for	Kotor	Kotor
ME-11, Name for	Mojkovac	Mojkovac
ME-12, Name for	Nikšić	Nikšić
ME-13, Name for	Plav	Plav
ME-14, Name for	Pljevlja	Pljevlja
ME-15, Name for	Plužine	Plužine
ME-16, Name for	Podgorica	Podgorica
ME-17, Name for	Rožaje	Rožaje
ME-18, Name for	Šavnik	Šavnik
ME-19, Name for	Tivat	Tivat
ME-20, Name for	Ulcinj	Ulcinj
ME-21, Name for	Žabljak	Žabljak
ME-22, Name for	Gusinje	Gusinje
ME-23, Name for	Petnjica	Petnjica
ME-24, Name for	Tuzi	Tuzi
MG-A, Name for	Toamasina	Toamasina
MG-D, Name for	Antsiranana	Antsiranana
MG-F, Name for	Fianarantsoa	Fianarantsoa
MG-M, Name for	Mahajanga	Mahajanga
MG-T, Name for	Antananarivo	Antananarivo
MG-U, Name for	Toliara	Toliara
MH-ALK, Name for	Ailuk	Ailuk
MH-ALL, Name for	Ailinglaplap	Ailinglaplap
MH-ARN, Name for	Arno	Arno
MH-AUR, Name for	Aur	Aur
MH-EBO, Name for	Ebon	Ebon
MH-ENI, Name for	Enewetak & Ujelang	Eniwetok en Ujelang
MH-JAB, Name for	Jabat	Jabat
MH-JAL, Name for	Jaluit	Jaluit
MH-KIL, Name for	Bikini & Kili	Bikini en Kili
MH-KWA, Name for	Kwajalein	Kwajalein
MH-L, Name for	Ralik chain	Ralik-keten
MH-LAE, Name for	Lae	Lae
MH-LIB, Name for	Lib	Lib
MH-LIK, Name for	Likiep	Likiep
MH-MAJ, Name for	Majuro	Majuro
MH-MAL, Name for	Maloelap	Maloelap
MH-MEJ, Name for	Mejit	Mejit
MH-MIL, Name for	Mili	Mili
MH-NMK, Name for	Namdrik	Namorik
MH-NMU, Name for	Namu	Namu
MH-RON, Name for	Rongelap	Rongelap
MH-T, Name for	Ratak chain	Ratak-keten
MH-UJA, Name for	Ujae	Ujae
MH-UTI, Name for	Utrik	Utirik
MH-WTH, Name for	Wotho	Wotho
MH-WTJ, Name for	Wotje	Wotje
MK-101, Name for	Veles	Veles
MK-102, Name for	Gradsko	Gradsko
MK-103, Name for	Demir Kapija	Demir Kapija
MK-104, Name for	Kavadarci	Kavadarci
MK-105, Name for	Lozovo	Lozovo
MK-106, Name for	Negotino	Negotino
MK-107, Name for	Rosoman	Rosoman
MK-108, Name for	Sveti Nikole	Sveti Nikole
MK-109, Name for	Čaška	Čaška
MK-201, Name for	Berovo	Berovo
MK-202, Name for	Vinica	Vinica
MK-203, Name for	Delčevo	Delčevo
MK-204, Name for	Zrnovci	Zrnovci
MK-205, Name for	Karbinci	Karbinci
MK-206, Name for	Kočani	Kočani
MK-207, Name for	Makedonska Kamenica	Makedonska Kamenica
MK-208, Name for	Pehčevo	Pehčevo
MK-209, Name for	Probištip	Probištip
MK-210, Name for	Češinovo-Obleševo	Češinovo-Obleševo
MK-211, Name for	Štip	Štip
MK-301, Name for	Vevčani	Vevčani
MK-303, Name for	Debar	Debar
MK-304, Name for	Debrca	Debrecen
MK-307, Name for	Kičevo	Kičevo
MK-308, Name for	Makedonski Brod	Makedonski Brod
MK-310, Name for	Ohrid	Ohrid
MK-311, Name for	Plasnica	Plasnica
MK-312, Name for	Struga	Struga
MK-313, Name for	Centar Župa	Centar Župa
MK-401, Name for	Bogdanci	Bogdanci
MK-402, Name for	Bosilovo	Bosilovo
MK-403, Name for	Valandovo	Valandovo
MK-404, Name for	Vasilevo	Vasilevo
MK-405, Name for	Gevgelija	Gevgelija
MK-406, Name for	Dojran	Dojran
MK-407, Name for	Konče	Konče
MK-408, Name for	Novo Selo	Novo Selo
MK-409, Name for	Radoviš	Radoviš
MK-410, Name for	Strumica	Strumica
MK-501, Name for	Bitola	Bitola
MK-502, Name for	Demir Hisar	Demir Hisar
MK-503, Name for	Dolneni	Dolneni
MK-504, Name for	Krivogaštani	Krivogaštani
MK-505, Name for	Kruševo	Kruševo
MK-506, Name for	Mogila	Mogila
MK-507, Name for	Novaci	Novaci
MK-508, Name for	Prilep	Prilep
MK-509, Name for	Resen	Resen
MK-601, Name for	Bogovinje	Bogovinje
MK-602, Name for	Brvenica	Brvenica
MK-603, Name for	Vrapčište	Vrapčište
MK-604, Name for	Gostivar	Gostivar
MK-605, Name for	Želino	Želino
MK-606, Name for	Jegunovce	Jegunovce
MK-607, Name for	Mavrovo i Rostuše	Mavrovo-i-Rostuša
MK-608, Name for	Tearce	Tearce
MK-609, Name for	Tetovo	Tetovo
MK-701, Name for	Kratovo	Kratovo
MK-702, Name for	Kriva Palanka	Kriva Palanka
MK-703, Name for	Kumanovo	Kumanovo
MK-704, Name for	Lipkovo	Lipkovo
MK-705, Name for	Rankovce	Rankovce
MK-706, Name for	Staro Nagoričane	Staro Nagoričane
MK-801, Name for	Aerodrom †	Aerodrom
MK-802, Name for	Aračinovo	Aračinovo
MK-803, Name for	Butel †	Butel
MK-804, Name for	Gazi Baba †	Gazi Baba
MK-805, Name for	Gjorče Petrov †	Gjorče Petrov
MK-806, Name for	Zelenikovo	Zelenikovo
MK-807, Name for	Ilinden	Ilinden
MK-808, Name for	Karpoš †	Karpoš
MK-809, Name for	Kisela Voda †	Kisela Voda
MK-810, Name for	Petrovec	Petrovec
MK-811, Name for	Saraj †	Saraj
MK-812, Name for	Sopište	Sopište
MK-813, Name for	Studeničani	Studeničani
MK-814, Name for	Centar †	Centar
MK-815, Name for	Čair †	Čair
MK-816, Name for	Čučer-Sandevo	Čučer Sandevo
MK-817, Name for	Šuto Orizari †	Šuto Orizari
ML-1, Name for	Kayes	Kayes
ML-10, Name for	Taoudénit	Taoudenni
ML-2, Name for	Koulikoro	Koulikoro
ML-3, Name for	Sikasso	Sikasso
ML-4, Name for	Ségou	Ségou
ML-5, Name for	Mopti	Mopti
ML-6, Name for	Tombouctou	Timboektoe
ML-7, Name for	Gao	Gao
ML-8, Name for	Kidal	Kidal
ML-9, Name for	Ménaka	Ménaka
ML-BKO, Name for	Bamako	Bamako
MM-01, Name for	Sagaing	Sagaing
MM-02, Name for	Bago	Bago
MM-03, Name for	Magway	Magway
MM-04, Name for	Mandalay	Mandalay
MM-05, Name for	Tanintharyi	Tanintharyi
MM-06, Name for	Yangon	Yangon
MM-07, Name for	Ayeyarwady	Ayeyarwady
MM-11, Name for	Kachin	Kachin
MM-12, Name for	Kayah	Kayah
MM-13, Name for	Kayin	Kayin
MM-14, Name for	Chin	Chin
MM-15, Name for	Mon	Mon
MM-16, Name for	Rakhine	Rakhine
MM-17, Name for	Shan	Shan
MM-18, Name for	Nay Pyi Taw	Naypyidaw
MN-035, Name for	Orhon	Orhon
MN-037, Name for	Darhan uul	Darhan uul
MN-039, Name for	Hentiy	Hentiy
MN-041, Name for	Hövsgöl	Hövsgöl
MN-043, Name for	Hovd	Hovd
MN-046, Name for	Uvs	Uvs
MN-047, Name for	Töv	Töv
MN-049, Name for	Selenge	Selenge
MN-051, Name for	Sühbaatar	Sühbaatar
MN-053, Name for	Ömnögovĭ	Ömnögovĭ
MN-055, Name for	Övörhangay	Övörhangaj
MN-057, Name for	Dzavhan	Dzavhan
MN-059, Name for	Dundgovĭ	Dundgovĭ
MN-061, Name for	Dornod	Dornod
MN-063, Name for	Dornogovĭ	Dornogovĭ
MN-064, Name for	Govĭ-Sümber	Govĭsümber
MN-065, Name for	Govĭ-Altay	Govĭ-Altay
MN-067, Name for	Bulgan	Bulgan
MN-069, Name for	Bayanhongor	Bayanhongor
MN-071, Name for	Bayan-Ölgiy	Bayan-Ölgi
MN-073, Name for	Arhangay	Arhangay
MN-1, Name for	Ulaanbaatar	Ulaanbaatar
MR-01, Name for	Hodh ech Chargui	Hodh ech Chargui
MR-02, Name for	Hodh el Gharbi	Hodh El Gharbi
MR-03, Name for	Assaba	Assaba
MR-04, Name for	Gorgol	Gorgol
MR-05, Name for	Brakna	Brakna
MR-06, Name for	Trarza	Trarza
MR-07, Name for	Adrar	Adrar
MR-08, Name for	Dakhlet Nouâdhibou	Dakhlet Nouadhibou
MR-09, Name for	Tagant	Tagant
MR-10, Name for	Guidimaka	Guidimaka
MR-11, Name for	Tiris Zemmour	Tiris Zemmour
MR-12, Name for	Inchiri	Inchiri
MR-13, Name for	Nouakchott Ouest	Nouakchott Ouest
MR-14, Name for	Nouakchott Nord	Nouakchott Nord
MR-15, Name for	Nouakchott Sud	Nouakchott Sud
MT-01, Name for	Attard	Attard
MT-02, Name for	Balzan	Balzan
MT-03, Name for	Birgu	Birgu
MT-04, Name for	Birkirkara	Birkirkara
MT-05, Name for	Birżebbuġa	Birżebbuġa
MT-06, Name for	Bormla	Bormla
MT-07, Name for	Dingli	Dingli
MT-08, Name for	Fgura	Fgura
MT-09, Name for	Floriana	Floriana
MT-10, Name for	Fontana	Fontana
MT-11, Name for	Gudja	Gudja
MT-12, Name for	Gżira	Gżira
MT-13, Name for	Għajnsielem	Għajnsielem
MT-14, Name for	Għarb	Għarb
MT-15, Name for	Għargħur	Għargħur
MT-16, Name for	Għasri	Għasri
MT-17, Name for	Għaxaq	Għaxaq
MT-18, Name for	Ħamrun	Ħamrun
MT-19, Name for	Iklin	Iklin
MT-20, Name for	Isla	Isla
MT-21, Name for	Kalkara	Kalkara
MT-22, Name for	Kerċem	Kerċem
MT-23, Name for	Kirkop	Kirkop
MT-24, Name for	Lija	Lija
MT-25, Name for	Luqa	Luqa
MT-26, Name for	Marsa	Marsa
MT-27, Name for	Marsaskala	Marsaskala
MT-28, Name for	Marsaxlokk	Marsaxlokk
MT-29, Name for	Mdina	Mdina
MT-30, Name for	Mellieħa	Mellieħa
MT-31, Name for	Mġarr	Mġarr
MT-32, Name for	Mosta	Mosta
MT-33, Name for	Mqabba	Mqabba
MT-34, Name for	Msida	Msida
MT-35, Name for	Mtarfa	Mtarfa
MT-36, Name for	Munxar	Munxar
MT-37, Name for	Nadur	Nadur
MT-38, Name for	Naxxar	Naxxar
MT-39, Name for	Paola	Paola
MT-40, Name for	Pembroke	Pembroke
MT-41, Name for	Pietà	Pietà
MT-42, Name for	Qala	Qala
MT-43, Name for	Qormi	Qormi
MT-44, Name for	Qrendi	Qrendi
MT-45, Name for	Rabat Gozo	Rabat
MT-46, Name for	Rabat Malta	Rabat Malta
MT-47, Name for	Safi	Safi
MT-48, Name for	Saint Julian's	Saint James
MT-49, Name for	Saint John	Saint John
MT-50, Name for	Saint Lawrence	San Lawrenz
MT-51, Name for	Saint Paul's Bay	Saint Paul
MT-52, Name for	Sannat	Sannat
MT-53, Name for	Saint Lucia's	Saint Louis
MT-54, Name for	Santa Venera	Santa Venera
MT-55, Name for	Siġġiewi	Siġġiewi
MT-56, Name for	Sliema	Sliema
MT-57, Name for	Swieqi	Swieqi
MT-58, Name for	Ta' Xbiex	Ta' Xbiex
MT-59, Name for	Tarxien	Tarxien
MT-60, Name for	Valletta	Valletta
MT-61, Name for	Xagħra	Xagħra
MT-62, Name for	Xewkija	Xewkija
MT-63, Name for	Xgħajra	Xgħajra
MT-64, Name for	Żabbar	Żabbar
MT-65, Name for	Żebbuġ Gozo	Żebbuġ Għawdex
MT-66, Name for	Żebbuġ Malta	Żebbuġ Malta
MT-67, Name for	Żejtun	Żejtun
MT-68, Name for	Żurrieq	Żurrieq
MU-AG, Name for	Agalega Islands	Agalega-eilanden
MU-BL, Name for	Black River	Black River
MU-CC, Name for	Cargados Carajos Shoals	Cargados Carajos Shoals
MU-FL, Name for	Flacq	Flacq
MU-GP, Name for	Grand Port	Grand Port
MU-MO, Name for	Moka	Moka
MU-PA, Name for	Pamplemousses	Pamplemousses
MU-PL, Name for	Port Louis	Port Louis
MU-PW, Name for	Plaines Wilhems	Plaines Wilhems
MU-RO, Name for	Rodrigues Island	Rodrigues-eiland
MU-RR, Name for	Rivière du Rempart	Rempart-rivier
MU-SA, Name for	Savanne	Savanne
MV-00, Name for	South Ari Atoll	Zuidelijke Ari-atol
MV-01, Name for	Addu City	Addu-atol
MV-02, Name for	North Ari Atoll	Noordelijke Ari-atol
MV-03, Name for	Faadhippolhu	Faadhippolhu-atol
MV-04, Name for	Felidhu Atoll	Felidhu-atol
MV-05, Name for	Hahdhunmathi	Haddhunmathi-atol
MV-07, Name for	North Thiladhunmathi	Noordelijke Thiladhunmathi-atol
MV-08, Name for	Kolhumadulu	Kolhumadulu-atol
MV-12, Name for	Mulaku Atoll	Mulaku-atol
MV-13, Name for	North Maalhosmadulu	Noordelijke Maalhosmadulhu-atol
MV-14, Name for	North Nilandhe Atoll	Noordelijke Nilandhé-atol
MV-17, Name for	South Nilandhe Atoll	Zuidelijke Nilandhé-atol
MV-20, Name for	South Maalhosmadulu	Zuidelijke Maalhosmadulhu-atol
MV-23, Name for	South Thiladhunmathi	Zuidelijke Thiladhunmathi-atol
MV-24, Name for	North Miladhunmadulu	Noordelijke Miladhunmadulhu-atol
MV-25, Name for	South Miladhunmadulu	Zuidelijke Miladhunmadulhu-atol
MV-26, Name for	Male Atoll	Malé-atol
MV-27, Name for	North Huvadhu Atoll	Noordelijke Huvadhu-atol
MV-28, Name for	South Huvadhu Atoll	Zuidelijke Huvadhu-atol
MV-29, Name for	Fuvammulah	Fuvammulah
MV-MLE, Name for	Male	Malé
MW-BA, Name for	Balaka	Balaka
MW-BL, Name for	Blantyre	Blantyre
MW-C, Name for	Central Region	Centrale Regio
MW-CK, Name for	Chikwawa	Chikwawa
MW-CR, Name for	Chiradzulu	Chiradzulu
MW-CT, Name for	Chitipa	Chitipa
MW-DE, Name for	Dedza	Dedza
MW-DO, Name for	Dowa	Dowa
MW-KR, Name for	Karonga	Karonga
MW-KS, Name for	Kasungu	Kasungu
MW-LI, Name for	Lilongwe	Lilongwe
MW-LK, Name for	Likoma	Likoma
MW-MC, Name for	Mchinji	Mchinji
MW-MG, Name for	Mangochi	Mangochi
MW-MH, Name for	Machinga	Machinga
MW-MU, Name for	Mulanje	Mulanje
MW-MW, Name for	Mwanza	Mwanza
MW-MZ, Name for	Mzimba	Mzimba
MW-N, Name for	Northern Region	Noordelijke Regio
MW-NB, Name for	Nkhata Bay	Nkhata Baai
MW-NE, Name for	Neno	Neno
MW-NI, Name for	Ntchisi	Ntchisi
MW-NK, Name for	Nkhotakota	Nkhotakota
MW-NS, Name for	Nsanje	Nsanje
MW-NU, Name for	Ntcheu	Ntcheu
MW-PH, Name for	Phalombe	Phalombe
MW-RU, Name for	Rumphi	Rumphi
MW-S, Name for	Southern Region	Zuidelijke Regio
MW-SA, Name for	Salima	Salima
MW-TH, Name for	Thyolo	Thyolo
MW-ZO, Name for	Zomba	Zomba
MX-AGU, Name for	Aguascalientes	Aguascalientes
MX-BCN, Name for	Baja California	Baja California; Neder-Californië
MX-BCS, Name for	Baja California Sur	Baja California Sur; Zuid-Neder-Californië
MX-CAM, Name for	Campeche	Campeche
MX-CHH, Name for	Chihuahua	Chihuahua
MX-CHP, Name for	Chiapas	Chiapas
MX-CMX, Name for	Ciudad de México	Mexico-Stad
MX-COA, Name for	Coahuila de Zaragoza	Coahuila de Zaragoza
MX-COL, Name for	Colima	Colima
MX-DUR, Name for	Durango	Durango
MX-GRO, Name for	Guerrero	Guerrero
MX-GUA, Name for	Guanajuato	Guanajuato
MX-HID, Name for	Hidalgo	Hidalgo
MX-JAL, Name for	Jalisco	Jalisco
MX-MEX, Name for	México	Mexico
MX-MIC, Name for	Michoacán de Ocampo	Michoacán de Ocampo
MX-MOR, Name for	Morelos	Morelos
MX-NAY, Name for	Nayarit	Nayarit
MX-NLE, Name for	Nuevo León	Nuevo León
MX-OAX, Name for	Oaxaca	Oaxaca
MX-PUE, Name for	Puebla	Puebla
MX-QUE, Name for	Querétaro	Querétaro
MX-ROO, Name for	Quintana Roo	Quintana Roo
MX-SIN, Name for	Sinaloa	Sinaloa
MX-SLP, Name for	San Luis Potosí	San Luis Potosí
MX-SON, Name for	Sonora	Sonora
MX-TAB, Name for	Tabasco	Tabasco
MX-TAM, Name for	Tamaulipas	Tamaulipas
MX-TLA, Name for	Tlaxcala	Tlaxcala
MX-VER, Name for	Veracruz de Ignacio de la Llave	Veracruz de Ignacio de la Llave
MX-YUC, Name for	Yucatán	Yucatán
MX-ZAC, Name for	Zacatecas	Zacatecas
MY-01, Name for	Johor	Johor
MY-02, Name for	Kedah	Kedah
MY-03, Name for	Kelantan	Kelantan
MY-04, Name for	Melaka	Malakka; Melaka
MY-05, Name for	Negeri Sembilan	Negeri Sembilan
MY-06, Name for	Pahang	Pahang
MY-07, Name for	Pulau Pinang	Penang; Pulau Pinang
MY-08, Name for	Perak	Perak
MY-09, Name for	Perlis	Perlis
MY-10, Name for	Selangor	Selangor
MY-11, Name for	Terengganu	Terengganu
MY-12, Name for	Sabah	Sabah
MY-13, Name for	Sarawak	Sarawak
MY-14, Name for	Wilayah Persekutuan Kuala Lumpur	Kuala Lumpur, Federaal Territorium
MY-15, Name for	Wilayah Persekutuan Labuan	Labuan, Federaal Territorium
MY-16, Name for	Wilayah Persekutuan Putrajaya	Putrajaya, Federaal Territorium
MZ-A, Name for	Niassa	Niassa
MZ-B, Name for	Manica	Manica
MZ-G, Name for	Gaza	Gaza
MZ-I, Name for	Inhambane	Inhambane
MZ-L, Name for	Maputo	Maputo
MZ-MPM, Name for	Maputo	Maputo
MZ-N, Name for	Nampula	Nampula
MZ-P, Name for	Cabo Delgado	Cabo Delgado
MZ-Q, Name for	Zambézia	Zambezia
MZ-S, Name for	Sofala	Sofala
MZ-T, Name for	Tete	Tete
NA-CA, Name for	Zambezi	Zambezia
NA-ER, Name for	Erongo	Erongo
NA-HA, Name for	Hardap	Hardap
NA-KA, Name for	//Karas	//Karas
NA-KE, Name for	Kavango East	Okavango
NA-KH, Name for	Khomas	Khomas
NA-KU, Name for	Kunene	Kunene
NA-KW, Name for	Kavango West	Okavango
NA-OD, Name for	Otjozondjupa	Otjozondjupa
NA-OH, Name for	Omaheke	Omaheke
NA-ON, Name for	Oshana	Oshana
NA-OS, Name for	Omusati	Omusati
NA-OT, Name for	Oshikoto	Oshikoto
NA-OW, Name for	Ohangwena	Ohangwena
NE-1, Name for	Agadez	Agadez
NE-2, Name for	Diffa	Diffa
NE-3, Name for	Dosso	Dosso
NE-4, Name for	Maradi	Maradi
NE-5, Name for	Tahoua	Tahoua
NE-6, Name for	Tillabéri	Tillabéri
NE-7, Name for	Zinder	Zinder
NE-8, Name for	Niamey	Niamey
NG-AB, Name for	Abia	Abia
NG-AD, Name for	Adamawa	Adamawa
NG-AK, Name for	Akwa Ibom	Akwa Ibom
NG-AN, Name for	Anambra	Anambra
NG-BA, Name for	Bauchi	Bauchi
NG-BE, Name for	Benue	Benue
NG-BO, Name for	Borno	Borno
NG-BY, Name for	Bayelsa	Bayelsa
NG-CR, Name for	Cross River	Cross River
NG-DE, Name for	Delta	Delta
NG-EB, Name for	Ebonyi	Ebonyi
NG-ED, Name for	Edo	Edo
NG-EK, Name for	Ekiti	Ekiti
NG-EN, Name for	Enugu	Enugu
NG-FC, Name for	Abuja Federal Capital Territory	Abuja Hoofdstedelijk Gewest
NG-GO, Name for	Gombe	Gombe
NG-IM, Name for	Imo	Imo
NG-JI, Name for	Jigawa	Jigawa
NG-KD, Name for	Kaduna	Kaduna
NG-KE, Name for	Kebbi	Kebbi
NG-KN, Name for	Kano	Kano
NG-KO, Name for	Kogi	Kogi
NG-KT, Name for	Katsina	Katsina
NG-KW, Name for	Kwara	Kwara
NG-LA, Name for	Lagos	Lagos
NG-NA, Name for	Nasarawa	Nassarawa
NG-NI, Name for	Niger	Niger
NG-OG, Name for	Ogun	Ogun
NG-ON, Name for	Ondo	Ondo
NG-OS, Name for	Osun	Osun
NG-OY, Name for	Oyo	Oyo
NG-PL, Name for	Plateau	Plateau
NG-RI, Name for	Rivers	Rivers
NG-SO, Name for	Sokoto	Sokoto
NG-TA, Name for	Taraba	Taraba
NG-YO, Name for	Yobe	Yobe
NG-ZA, Name for	Zamfara	Zamfara
NI-AN, Name for	Costa Caribe Norte	Noord-Camarines
NI-AS, Name for	Costa Caribe Sur	Zuid-Camarines
NI-BO, Name for	Boaco	Boaco
NI-CA, Name for	Carazo	Carazo
NI-CI, Name for	Chinandega	Chinandega
NI-CO, Name for	Chontales	Chontales
NI-ES, Name for	Estelí	Estelí
NI-GR, Name for	Granada	Granada
NI-JI, Name for	Jinotega	Jinotega
NI-LE, Name for	León	León
NI-MD, Name for	Madriz	Madriz
NI-MN, Name for	Managua	Managua
NI-MS, Name for	Masaya	Masaya
NI-MT, Name for	Matagalpa	Matagalpa
NI-NS, Name for	Nueva Segovia	Nueva Segovia
NI-RI, Name for	Rivas	Rivas
NI-SJ, Name for	Río San Juan	Río San Juan
NL-AW, Name for	Aruba	Aruba
NL-BQ1, Name for	Bonaire	Bonaire
NL-BQ2, Name for	Saba	Saba
NL-BQ3, Name for	Sint Eustatius	Sint Eustatius
NL-CW, Name for	Curaçao	Curaçao
NL-DR, Name for	Drenthe	Drenthe
NL-FL, Name for	Flevoland	Flevoland
NL-FR, Name for	Fryslân	Friesland
NL-GE, Name for	Gelderland	Gelderland
NL-GR, Name for	Groningen	Groningen
NL-LI, Name for	Limburg	Limburg
NL-NB, Name for	Noord-Brabant	Noord-Brabant
NL-NH, Name for	Noord-Holland	Noord-Holland
NL-OV, Name for	Overijssel	Overijssel
NL-SX, Name for	Sint Maarten	Sint Maarten
NL-UT, Name for	Utrecht	Utrecht
NL-ZE, Name for	Zeeland	Zeeland
NL-ZH, Name for	Zuid-Holland	Zuid-Holland
NO-03, Name for	Oslo	Oslo
NO-11, Name for	Rogaland	Rogaland
NO-15, Name for	Møre og Romsdal	Møre og Romsdal
NO-18, Name for	Nordland	Nordland
NO-21, Name for	Svalbard (Arctic Region)	Spitsbergen (Arctische regio); Svalbard (Arctische regio)
NO-22, Name for	Jan Mayen (Arctic Region)	Jan Mayen (Arctische regio)
NO-30, Name for	Viken	Viken
NO-34, Name for	Innlandet	Innlandet
NO-38, Name for	Vestfold og Telemark	Vestfold og Telemark
NO-42, Name for	Agder	Agder
NO-46, Name for	Vestland	Vestland
NO-50, Name for	Trööndelage	Trøndelag
NO-54, Name for	Romssa ja Finnmárkku	Troms og Finnmark
NP-1, Name for	Central	Central
NP-2, Name for	Mid Western	West
NP-3, Name for	Western	Western
NP-4, Name for	Eastern	Oost
NP-5, Name for	Far Western	West
NP-BA, Name for	Bagmati	Bagmati
NP-BH, Name for	Bheri	Bheri
NP-DH, Name for	Dhawalagiri	Dhawalagiri
NP-GA, Name for	Gandaki	Gandaki
NP-JA, Name for	Janakpur	Janakpur
NP-KA, Name for	Karnali	Karnali
NP-KO, Name for	Kosi	Kosi
NP-LU, Name for	Lumbini	Lumbini
NP-MA, Name for	Mahakali	Mahakali
NP-ME, Name for	Mechi	Mechi
NP-NA, Name for	Narayani	Narayani
NP-P1, Name for	Province 1	Princes Town
NP-P2, Name for	Province 2	Princes Town
NP-P3, Name for	Bāgmatī	Bagmati
NP-P4, Name for	Gandaki	Gandaki
NP-P5, Name for	Province 5	Princes Town
NP-P6, Name for	Karnali	Karnali
NP-P7, Name for	Sudūr Pashchim	Sudur Pashchimanchal
NP-RA, Name for	Rapti	Rapti
NP-SA, Name for	Sagarmatha	Sagarmatha
NP-SE, Name for	Seti	Seti
NR-01, Name for	Aiwo	Aiwo
NR-02, Name for	Anabar	Anabar
NR-03, Name for	Anetan	Anetan
NR-04, Name for	Anibare	Anibare
NR-05, Name for	Baitsi	Baiti
NR-06, Name for	Boe	Boe
NR-07, Name for	Buada	Buada
NR-08, Name for	Denigomodu	Denigomodu
NR-09, Name for	Ewa	Ewa
NR-10, Name for	Ijuw	Ijuw
NR-11, Name for	Meneng	Meneng
NR-12, Name for	Nibok	Nibok
NR-13, Name for	Uaboe	Uaboe
NR-14, Name for	Yaren	Yaren
NZ-AUK, Name for	Auckland	Auckland
NZ-BOP, Name for	Bay of Plenty	Bay of Plenty
NZ-CAN, Name for	Canterbury	Canterbury
NZ-CIT, Name for	Chatham Islands Territory	Chatham Islands Territory
NZ-GIS, Name for	Gisborne	Gisborne
NZ-HKB, Name for	Hawke's Bay	Hawke's Bay
NZ-MBH, Name for	Marlborough	Marlborough
NZ-MWT, Name for	Manawatu-Wanganui	Manawatu-Wanganui
NZ-NSN, Name for	Nelson	Nelson City
NZ-NTL, Name for	Northland	Noordland
NZ-OTA, Name for	Otago	Otago
NZ-STL, Name for	Southland	Zuidland
NZ-TAS, Name for	Tasman	Tasmanië
NZ-TKI, Name for	Taranaki	Taranaki
NZ-WGN, Name for	Wellington	Wellington
NZ-WKO, Name for	Waikato	Waikato
NZ-WTC, Name for	West Coast	Westkust
OM-BJ, Name for	Janūb al Bāţinah	Al Batinah
OM-BS, Name for	Shamāl al Bāţinah	Al Batinah
OM-BU, Name for	Al Buraymī	Al Buraymī
OM-DA, Name for	Ad Dākhilīyah	Ad Dachiliyah
OM-MA, Name for	Masqaţ	Masqaţ
OM-MU, Name for	Musandam	Musandam
OM-SJ, Name for	Janūb ash Sharqīyah	Ash Sharqiyah
OM-SS, Name for	Shamāl ash Sharqīyah	Ash Sharqiyah
OM-WU, Name for	Al Wusţá	Al Wusta
OM-ZA, Name for	Az̧ Z̧āhirah	Az Zahirah
OM-ZU, Name for	Z̧ufār	Z̧ufār
PA-1, Name for	Bocas del Toro	Bocas del Toro
PA-10, Name for	Panamá Oeste	Panama
PA-2, Name for	Coclé	Coclé
PA-3, Name for	Colón	Colón
PA-4, Name for	Chiriquí	Chiriquí
PA-5, Name for	Darién	Darién
PA-6, Name for	Herrera	Herrera
PA-7, Name for	Los Santos	Los Santos
PA-8, Name for	Panamá	Panama
PA-9, Name for	Veraguas	Veraguas
PA-EM, Name for	Emberá	Emberá
PA-KY, Name for	Guna Yala	Kuna Yala
PA-NB, Name for	Ngöbe-Buglé	Ngöbe-Buglé
PE-AMA, Name for	Amarumayu	Amazonas
PE-ANC, Name for	Ancash	Áncash
PE-APU, Name for	Apurimaq	Apurímac
PE-ARE, Name for	Arequipa	Arequipa
PE-AYA, Name for	Ayacucho	Ayacucho
PE-CAJ, Name for	Cajamarca	Cajamarca
PE-CAL, Name for	El Callao	Callao
PE-CUS, Name for	Cusco	Cuzco
PE-HUC, Name for	Huánuco	Huánuco
PE-HUV, Name for	Huancavelica	Huancavelica
PE-ICA, Name for	Ica	Ica
PE-JUN, Name for	Hunin	Junín
PE-LAL, Name for	La Libertad	La Libertad
PE-LAM, Name for	Lambayeque	Lambayeque
PE-LIM, Name for	Lima	Lima
PE-LMA, Name for	Lima hatun llaqta	Lima (stad)
PE-LOR, Name for	Loreto	Loreto
PE-MDD, Name for	Madre de Dios	Madre de Dios
PE-MOQ, Name for	Moquegua	Moquegua
PE-PAS, Name for	Pasco	Pasco
PE-PIU, Name for	Piura	Piura
PE-PUN, Name for	Puno	Puno
PE-SAM, Name for	San Martin	San Martín
PE-TAC, Name for	Tacna	Tacna
PE-TUM, Name for	Tumbes	Tumbes
PE-UCA, Name for	Ucayali	Ucayali
PG-CPK, Name for	Chimbu	Chimbu
PG-CPM, Name for	Central	Central
PG-EBR, Name for	East New Britain	East New Britain
PG-EHG, Name for	Eastern Highlands	Eastern Highlands
PG-EPW, Name for	Enga	Enga
PG-ESW, Name for	East Sepik	East Sepik
PG-GPK, Name for	Gulf	Gulf
PG-HLA, Name for	Hela	Hela
PG-JWK, Name for	Jiwaka	Jiwaka
PG-MBA, Name for	Milne Bay	Milne Bay
PG-MPL, Name for	Morobe	Morobe
PG-MPM, Name for	Madang	Madang
PG-MRL, Name for	Manus	Manus
PG-NCD, Name for	National Capital District (Port Moresby)	National Capital District (Port Moresby)
PG-NIK, Name for	New Ireland	New Ireland
PG-NPP, Name for	Northern	Northern
PG-NSB, Name for	Bougainville	Bougainville
PG-SAN, Name for	West Sepik	West Sepik
PG-SHM, Name for	Southern Highlands	Southern Highlands
PG-WBK, Name for	West New Britain	West New Britain
PG-WHM, Name for	Western Highlands	Western Highlands
PG-WPD, Name for	Western	Western
PH-00, Name for	National Capital Region	Nationale Hoofstadregio
PH-01, Name for	Ilocos (Region I)	Ilocos (Regio I)
PH-02, Name for	Cagayan Valley (Region II)	Cagayan Valley (Regio II)
PH-03, Name for	Central Luzon (Region III)	Central Luzon (Regio III)
PH-05, Name for	Bicol (Region V)	Bicol (Regio V)
PH-06, Name for	Western Visayas (Region VI)	Western Visayas (Regio VI)
PH-07, Name for	Central Visayas (Region VII)	Central Visayas (Regio VII)
PH-08, Name for	Eastern Visayas (Region VIII)	Eastern Visayas (Regio VIII)
PH-09, Name for	Zamboanga Peninsula (Region IX)	Zamboanga Peninsula (Regio IX)
PH-10, Name for	Northern Mindanao (Region X)	Northern Mindanao (Regio X)
PH-11, Name for	Davao (Region XI)	Davao (Regio XI)
PH-12, Name for	Soccsksargen (Region XII)	Soccsksargen (Regio XII)
PH-13, Name for	Caraga (Region XIII)	Caraga (Regio XIII)
PH-14, Name for	Autonomous Region in Muslim Mindanao (ARMM)	Autonome Regio in Muslim Mindanao (ARMM)
PH-15, Name for	Cordillera Administrative Region (CAR)	Cordillera Administratieve Regio (CAR)
PH-40, Name for	Calabarzon (Region IV-A)	Calabarzon (Regio IV-A)
PH-41, Name for	Mimaropa (Region IV-B)	Mimaropa (Regio IV-B)
PH-ABR, Name for	Abra	Abra
PH-AGN, Name for	Agusan del Norte	Agusan del Norte
PH-AGS, Name for	Agusan del Sur	Agusan del Sur
PH-AKL, Name for	Aklan	Aklan
PH-ALB, Name for	Albay	Albay
PH-ANT, Name for	Antique	Antique
PH-APA, Name for	Apayao	Apayao
PH-AUR, Name for	Aurora	Aurora
PH-BAN, Name for	Bataan	Batasn
PH-BAS, Name for	Basilan	Basilan
PH-BEN, Name for	Benguet	Benguet
PH-BIL, Name for	Biliran	Biliran
PH-BOH, Name for	Bohol	Bohol
PH-BTG, Name for	Batangas	Batangas
PH-BTN, Name for	Batanes	Batanes
PH-BUK, Name for	Bukidnon	Bukidnon
PH-BUL, Name for	Bulacan	Bulacan
PH-CAG, Name for	Cagayan	Cagayan
PH-CAM, Name for	Camiguin	Camiguin
PH-CAN, Name for	Camarines Norte	Camarines Norte
PH-CAP, Name for	Capiz	Capiz
PH-CAS, Name for	Camarines Sur	Camarines Sur
PH-CAT, Name for	Catanduanes	Catanduanes
PH-CAV, Name for	Cavite	Cavite
PH-CEB, Name for	Cebu	Cebu
PH-COM, Name for	Davao de Oro	Davao de Oro
PH-DAO, Name for	Davao Oriental	Davao Oriental
PH-DAS, Name for	Davao del Sur	Davao del Sur
PH-DAV, Name for	Davao del Norte	Davao del Norte
PH-DIN, Name for	Dinagat Islands	Dinagat Islands
PH-DVO, Name for	Davao Occidental	Davao Occidental
PH-EAS, Name for	Eastern Samar	Eastern Samar
PH-GUI, Name for	Guimaras	Guimaras
PH-IFU, Name for	Ifugao	Ifugao
PH-ILI, Name for	Iloilo	Iloilo
PH-ILN, Name for	Ilocos Norte	Ilocos Norte
PH-ILS, Name for	Ilocos Sur	Ilocos Sur
PH-ISA, Name for	Isabela	Isabela
PH-KAL, Name for	Kalinga	Ealing
PH-LAG, Name for	Laguna	Laguna
PH-LAN, Name for	Lanao del Norte	Lanao del Norte
PH-LAS, Name for	Lanao del Sur	Lanao del Sur
PH-LEY, Name for	Leyte	Leyte
PH-LUN, Name for	La Union	La Union
PH-MAD, Name for	Marinduque	Marinduque
PH-MAG, Name for	Maguindanao	Maguindanao
PH-MAS, Name for	Masbate	Masbate
PH-MDC, Name for	Mindoro Occidental	Mindoro Occidental
PH-MDR, Name for	Mindoro Oriental	Mindoro Oriental
PH-MOU, Name for	Mountain Province	Mountain Province
PH-MSC, Name for	Misamis Occidental	Misamis Occidental
PH-MSR, Name for	Misamis Oriental	Misamis Oriental
PH-NCO, Name for	Cotabato	Cotabato
PH-NEC, Name for	Negros Occidental	Negros Occidental
PH-NER, Name for	Negros Oriental	Negros Oriental
PH-NSA, Name for	Northern Samar	Northern Samar
PH-NUE, Name for	Nueva Ecija	Nueva Ecija
PH-NUV, Name for	Nueva Vizcaya	Nueva Vizcaya
PH-PAM, Name for	Pampanga	Pampanga
PH-PAN, Name for	Pangasinan	Pangasinaans
PH-PLW, Name for	Palawan	Palawan
PH-QUE, Name for	Quezon	Quezon
PH-QUI, Name for	Quirino	Quirino
PH-RIZ, Name for	Rizal	Rizal
PH-ROM, Name for	Romblon	Romblon
PH-SAR, Name for	Sarangani	Sarangani
PH-SCO, Name for	South Cotabato	South Cotabato
PH-SIG, Name for	Siquijor	Siquijor
PH-SLE, Name for	Southern Leyte	Southern Leyte
PH-SLU, Name for	Sulu	Sulu
PH-SOR, Name for	Sorsogon	Sorsogon
PH-SUK, Name for	Sultan Kudarat	Sultan Kudarat
PH-SUN, Name for	Surigao del Norte	Surigao del Norte
PH-SUR, Name for	Surigao del Sur	Surigao del Sur
PH-TAR, Name for	Tarlac	Tarlac
PH-TAW, Name for	Tawi-Tawi	Tawi-Tawi
PH-WSA, Name for	Samar	Samarkand
PH-ZAN, Name for	Zamboanga del Norte	Zamboanga del Norte
PH-ZAS, Name for	Zamboanga del Sur	Zamboanga del Sur
PH-ZMB, Name for	Zambales	Zambales
PH-ZSI, Name for	Zamboanga Sibugay	Zamboanga Sibugay
PK-BA, Name for	Balochistan	Beloetsjistan
PK-GB, Name for	Gilgit-Baltistan	Gilgit-Baltistan
PK-IS, Name for	Islamabad	Islamabad
PK-JK, Name for	Azad Jammu and Kashmir	Jammu en Kashmir
PK-KP, Name for	Khyber Pakhtunkhwa	Khyber Pakhtunkhwa
PK-PB, Name for	Punjab	Punjab
PK-SD, Name for	Sindh	Sindh
PL-02, Name for	Dolnośląskie	Dolnoslazki
PL-04, Name for	Kujawsko-pomorskie	Kujawsko-pomorski
PL-06, Name for	Lubelskie	Lublin
PL-08, Name for	Lubuskie	Lubusz
PL-10, Name for	Łódzkie	Łódź
PL-12, Name for	Małopolskie	Klein-Polen
PL-14, Name for	Mazowieckie	Masovië
PL-16, Name for	Opolskie	Opole
PL-18, Name for	Podkarpackie	Subkarpaten
PL-20, Name for	Podlaskie	Podlachië
PL-22, Name for	Pomorskie	Pommeren
PL-24, Name for	Śląskie	Silezië
PL-26, Name for	Świętokrzyskie	Heilig Kruis; Święty Krzyż
PL-28, Name for	Warmińsko-mazurskie	Ermland-Mazurië
PL-30, Name for	Wielkopolskie	Groot-Polen
PL-32, Name for	Zachodniopomorskie	West-Pommeren
PS-BTH, Name for	Bethlehem	Bethlehem
PS-DEB, Name for	Deir El Balah	Deir El Balah
PS-GZA, Name for	Gaza	Gaza
PS-HBN, Name for	Hebron	Hebron
PS-JEM, Name for	Jerusalem	Jeruzalem
PS-JEN, Name for	Jenin	Jenin
PS-JRH, Name for	Jericho and Al Aghwar	Jericho
PS-KYS, Name for	Khan Yunis	Khan Yunis
PS-NBS, Name for	Nablus	Nablus
PS-NGZ, Name for	North Gaza	Noord-Gaza
PS-QQA, Name for	Qalqilya	Qalqilya
PS-RBH, Name for	Ramallah	Ramallah
PS-RFH, Name for	Rafah	Rafah
PS-SLT, Name for	Salfit	Salfit
PS-TBS, Name for	Tubas	Tubas
PS-TKM, Name for	Tulkarm	Tulkarm
PT-01, Name for	Aveiro	Aveiro
PT-02, Name for	Beja	Beja
PT-03, Name for	Braga	Braga
PT-04, Name for	Bragança	Bragança
PT-05, Name for	Castelo Branco	Castelo Branco
PT-06, Name for	Coimbra	Coimbra
PT-07, Name for	Évora	Évora
PT-08, Name for	Faro	Faro
PT-09, Name for	Guarda	Guarda
PT-10, Name for	Leiria	Leiria
PT-11, Name for	Lisboa	Lissabon
PT-12, Name for	Portalegre	Portalegre
PT-13, Name for	Porto	Porto
PT-14, Name for	Santarém	Santarém
PT-15, Name for	Setúbal	Setúbal
PT-16, Name for	Viana do Castelo	Viana do Castelo
PT-17, Name for	Vila Real	Vila Real
PT-18, Name for	Viseu	Viseu
PT-20, Name for	Região Autónoma dos Açores	Autonome Regio Azoren
PT-30, Name for	Região Autónoma da Madeira	Autonome Regio Madeira
PW-002, Name for	Aimeliik	Aimeliik
PW-004, Name for	Airai	Airai
PW-010, Name for	Angaur	Angaur
PW-050, Name for	Hatohobei	Hatobohei
PW-100, Name for	Kayangel	Kayangel
PW-150, Name for	Koror	Koror
PW-212, Name for	Melekeok	Melekeok
PW-214, Name for	Ngaraard	Ngaraard
PW-218, Name for	Ngarchelong	Ngarchelong
PW-222, Name for	Ngardmau	Ngardmau
PW-224, Name for	Ngatpang	Ngatpang
PW-226, Name for	Ngchesar	Ngchesar
PW-227, Name for	Ngeremlengui	Ngeremlengui
PW-228, Name for	Ngiwal	Ngiwal
PW-350, Name for	Peleliu	Peleliu
PW-370, Name for	Sonsorol	Sonsorol
PY-1, Name for	Concepción	Concepción
PY-10, Name for	Alto Paraná	Hoog-Paraná
PY-11, Name for	Central	Central
PY-12, Name for	Ñeembucú	Ñeembucú
PY-13, Name for	Amambay	Amambay
PY-14, Name for	Canindeyú	Canindeyú
PY-15, Name for	Presidente Hayes	President Hayes
PY-16, Name for	Alto Paraguay	Hoog-Paraguay
PY-19, Name for	Boquerón	Boquerón
PY-2, Name for	San Pedro	San Pedro
PY-3, Name for	Cordillera	Cordillera
PY-4, Name for	Guairá	Guairá
PY-5, Name for	Caaguazú	Caaguazú
PY-6, Name for	Caazapá	Caazapá
PY-7, Name for	Itapúa	Itapúa
PY-8, Name for	Misiones	Misiones
PY-9, Name for	Paraguarí	Paraguarí
PY-ASU, Name for	Asunción	Asunción
QA-DA, Name for	Ad Dawḩah	Ad Dawhah
QA-KH, Name for	Al Khawr wa adh Dhakhīrah	Al Khawr wa adh Dhakhīrah
QA-MS, Name for	Ash Shamāl	Ash Shamal
QA-RA, Name for	Ar Rayyān	Ar Rayyan
QA-SH, Name for	Ash Shīḩānīyah	Ash Shamallyah
QA-US, Name for	Umm Şalāl	Umm Salal
QA-WA, Name for	Al Wakrah	Al Wakrah
QA-ZA, Name for	Az̧ Z̧a‘āyin	Az Za'ayin
RO-AB, Name for	Alba	Alba
RO-AG, Name for	Argeș	Argeș
RO-AR, Name for	Arad	Arad
RO-B, Name for	București	Boekarest
RO-BC, Name for	Bacău	Bacău
RO-BH, Name for	Bihor	Bihor
RO-BN, Name for	Bistrița-Năsăud	Bistrița-Năsăud
RO-BR, Name for	Brăila	Brăila
RO-BT, Name for	Botoșani	Botoșani
RO-BV, Name for	Brașov	Brașov
RO-BZ, Name for	Buzău	Buzău
RO-CJ, Name for	Cluj	Cluj
RO-CL, Name for	Călărași	Călărași
RO-CS, Name for	Caraș-Severin	Caraș-Severin
RO-CT, Name for	Constanța	Constanța
RO-CV, Name for	Covasna	Covasna
RO-DB, Name for	Dâmbovița	Dâmbovița
RO-DJ, Name for	Dolj	Dolj
RO-GJ, Name for	Gorj	Gorj
RO-GL, Name for	Galați	Galați
RO-GR, Name for	Giurgiu	Giurgiu
RO-HD, Name for	Hunedoara	Hunedoara
RO-HR, Name for	Harghita	Harghita
RO-IF, Name for	Ilfov	Ilfov
RO-IL, Name for	Ialomița	Ialomița
RO-IS, Name for	Iași	Iași
RO-MH, Name for	Mehedinți	Mehedinți
RO-MM, Name for	Maramureș	Maramureș
RO-MS, Name for	Mureș	Mureș
RO-NT, Name for	Neamț	Neamț
RO-OT, Name for	Olt	Olt
RO-PH, Name for	Prahova	Prahova
RO-SB, Name for	Sibiu	Sibiu
RO-SJ, Name for	Sălaj	Sălaj
RO-SM, Name for	Satu Mare	Satu Mare
RO-SV, Name for	Suceava	Suceava
RO-TL, Name for	Tulcea	Tulcea
RO-TM, Name for	Timiș	Timiș
RO-TR, Name for	Teleorman	Teleorman
RO-VL, Name for	Vâlcea	Vâlcea
RO-VN, Name for	Vrancea	Vrancea
RO-VS, Name for	Vaslui	Vaslui
RS-00, Name for	Beograd	Beograd
RS-01, Name for	Severnobački okrug	Noord-Bačka
RS-02, Name for	Srednjebanatski okrug	Centraal-Banaat
RS-03, Name for	Severnobanatski okrug	Noord-Banaat
RS-04, Name for	Južnobanatski okrug	Zuid-Banaat
RS-05, Name for	Zapadnobački okrug	West-Bačka
RS-06, Name for	Južnobački okrug	Zuid-Bačka
RS-07, Name for	Sremski okrug	Srem
RS-08, Name for	Mačvanski okrug	Mačva
RS-09, Name for	Kolubarski okrug	Kolubara
RS-10, Name for	Podunavski okrug	Podunavlje
RS-11, Name for	Braničevski okrug	Braničevo
RS-12, Name for	Šumadijski okrug	Šumadija
RS-13, Name for	Pomoravski okrug	Pomoravlje
RS-14, Name for	Borski okrug	Bor
RS-15, Name for	Zaječarski okrug	Zaječar
RS-16, Name for	Zlatiborski okrug	Zlatibor
RS-17, Name for	Moravički okrug	Moravica
RS-18, Name for	Raški okrug	Raška
RS-19, Name for	Rasinski okrug	Rasina
RS-20, Name for	Nišavski okrug	Nišava
RS-21, Name for	Toplički okrug	Toplica
RS-22, Name for	Pirotski okrug	Pirot
RS-23, Name for	Jablanički okrug	Jablanica
RS-24, Name for	Pčinjski okrug	Pčinja
RS-25, Name for	Kosovski okrug	Kosovo
RS-26, Name for	Pećki okrug	Peć
RS-27, Name for	Prizrenski okrug	Prizren
RS-28, Name for	Kosovsko-Mitrovački okrug	Kosovska Mitrovica
RS-29, Name for	Kosovsko-Pomoravski okrug	Kosovo-Pomoravlje
RS-KM, Name for	Kosovo-Metohija	Kosovo-Metohija
RS-VO, Name for	Vojvodina	Vojvodina
RU-AD, Name for	Adygeja, Respublika	Adygeya, Republiek
RU-AL, Name for	Altaj, Respublika	Altaj, Republiek
RU-ALT, Name for	Altajskij kraj	Altaj, Kraj
RU-AMU, Name for	Amurskaja oblast'	Amoer, Oblast
RU-ARK, Name for	Arhangel'skaja oblast'	Arkhangelsk, Oblast
RU-AST, Name for	Astrahanskaja oblast'	Astrachan, Oblast
RU-BA, Name for	Bashkortostan, Respublika	Basjkirostan, Republiek
RU-BEL, Name for	Belgorodskaja oblast'	Belgorod, Oblast
RU-BRY, Name for	Brjanskaja oblast'	Brjansk, Oblast
RU-BU, Name for	Burjatija, Respublika	Boerjatië, Republiek
RU-CE, Name for	Chechenskaya Respublika	Tsjetsjenië, Republiek
RU-CHE, Name for	Chelyabinskaya oblast'	Tsjeljabinsk, Oblast
RU-CHU, Name for	Chukotskiy avtonomnyy okrug	Tsjoekotka, Autonoom District
RU-CU, Name for	Chuvashskaya Respublika	Tsjoevasjië, Republiek
RU-DA, Name for	Dagestan, Respublika	Dagestan, Republiek
RU-IN, Name for	Ingushetiya, Respublika	Ingoesjetië, Republiek
RU-IRK, Name for	Irkutskaja oblast'	Irkoetsk, Oblast
RU-IVA, Name for	Ivanovskaja oblast'	Ivanovo, Oblast
RU-KAM, Name for	Kamchatskiy kray	Kamtsjatka, Kraj
RU-KB, Name for	Kabardino-Balkarskaja Respublika	Kabardië-Balkarië, Republiek
RU-KC, Name for	Karachayevo-Cherkesskaya Respublika	Karatsjaj-Tsjerkessië, Republiek
RU-KDA, Name for	Krasnodarskij kraj	Krasnodar, Kraj
RU-KEM, Name for	Kemerovskaja oblast'	Kemerovo, Oblast
RU-KGD, Name for	Kaliningradskaja oblast'	Kaliningrad, Oblast
RU-KGN, Name for	Kurganskaja oblast'	Koergan, Oblast
RU-KHA, Name for	Habarovskij kraj	Chabarovsk, Kraj
RU-KHM, Name for	Hanty-Mansijskij avtonomnyj okrug	Chanto-Mansië, Autonoom District
RU-KIR, Name for	Kirovskaja oblast'	Kirov, Oblast
RU-KK, Name for	Hakasija, Respublika	Chakassië, Republiek
RU-KL, Name for	Kalmykija, Respublika	Kalmukkië, Republiek
RU-KLU, Name for	Kaluzhskaya oblast'	Kaloega, Oblast
RU-KO, Name for	Komi, Respublika	Komi, Republiek
RU-KOS, Name for	Kostromskaja oblast'	Kostroma, Oblast
RU-KR, Name for	Karelija, Respublika	Karelië, Republiek
RU-KRS, Name for	Kurskaja oblast'	Koersk, Oblast
RU-KYA, Name for	Krasnojarskij kraj	Krasnojarsk, Kraj
RU-LEN, Name for	Leningradskaja oblast'	Leningrad, Oblast
RU-LIP, Name for	Lipeckaja oblast'	Lipetsk, Oblast
RU-MAG, Name for	Magadanskaja oblast'	Magadan, Oblast
RU-ME, Name for	Marij Èl, Respublika	Mari El, Republiek
RU-MO, Name for	Mordovija, Respublika	Mordovië, Republiek
RU-MOS, Name for	Moskovskaja oblast'	Moskou, Oblast
RU-MOW, Name for	Moskva	Moskou
RU-MUR, Name for	Murmanskaja oblast'	Moermansk, Oblast
RU-NEN, Name for	Neneckij avtonomnyj okrug	Nenetsië, Autonoom District
RU-NGR, Name for	Novgorodskaja oblast'	Novgorod, Oblast
RU-NIZ, Name for	Nizhegorodskaya oblast'	Nizjni Novgorod, Oblast
RU-NVS, Name for	Novosibirskaja oblast'	Novosibirsk, Oblast
RU-OMS, Name for	Omskaja oblast'	Omsk, Oblast
RU-ORE, Name for	Orenburgskaja oblast'	Orenburg, Oblast
RU-ORL, Name for	Orlovskaja oblast'	Orjol, Oblast
RU-PER, Name for	Permskij kraj	Perm, Kraj
RU-PNZ, Name for	Penzenskaja oblast'	Penza, Oblast
RU-PRI, Name for	Primorskij kraj	Primorski, Kraj
RU-PSK, Name for	Pskovskaja oblast'	Pskov, Oblast
RU-ROS, Name for	Rostovskaja oblast'	Rostov, Oblast
RU-RYA, Name for	Rjazanskaja oblast'	Rjazan, Oblast
RU-SA, Name for	Saha, Respublika	Jakoetië; Sacha, Republiek
RU-SAK, Name for	Sahalinskaja oblast'	Sachalin, Oblast
RU-SAM, Name for	Samarskaja oblast'	Samara, Oblast
RU-SAR, Name for	Saratovskaja oblast'	Saratov, Oblast
RU-SE, Name for	Severnaja Osetija, Respublika	Noord-Ossetië; Noord-Ossetië-Alanië, Republiek
RU-SMO, Name for	Smolenskaja oblast'	Smolensk, Oblast
RU-SPE, Name for	Sankt-Peterburg	Sint-Petersburg
RU-STA, Name for	Stavropol'skij kraj	Stavropol, Kraj
RU-SVE, Name for	Sverdlovskaja oblast'	Sverdlovsk, Oblast
RU-TA, Name for	Tatarstan, Respublika	Tatarije, Republiek; Tatarstan, Republiek
RU-TAM, Name for	Tambovskaja oblast'	Tambov, Oblast
RU-TOM, Name for	Tomskaja oblast'	Tomsk, Oblast
RU-TUL, Name for	Tul'skaja oblast'	Toela, Oblast
RU-TVE, Name for	Tverskaja oblast'	Tver, Oblast
RU-TY, Name for	Tyva, Respublika	Toeva, Republiek
RU-TYU, Name for	Tjumenskaja oblast'	Tjoemen, Oblast
RU-UD, Name for	Udmurtskaja Respublika	Oedmoertië, Republiek
RU-ULY, Name for	Ul'janovskaja oblast'	Oeljanovsk, Oblast
RU-VGG, Name for	Volgogradskaja oblast'	Wolgograd, Oblast
RU-VLA, Name for	Vladimirskaja oblast'	Vladimir, Oblast
RU-VLG, Name for	Vologodskaja oblast'	Vologda, Oblast
RU-VOR, Name for	Voronezhskaya oblast'	Voronezj, Oblast
RU-YAN, Name for	Jamalo-Neneckij avtonomnyj okrug	Jamalië, Autonoom District
RU-YAR, Name for	Jaroslavskaja oblast'	Jaroslavl, Oblast
RU-YEV, Name for	Evrejskaja avtonomnaja oblast'	Joodse Autonome Oblast
RU-ZAB, Name for	Zabajkal'skij kraj	Zabajkalski, Kraj
RW-01, Name for	City of Kigali	Kigali
RW-02, Name for	Eastern	Oost
RW-03, Name for	Northern	Northern
RW-04, Name for	Western	Western
RW-05, Name for	Southern	Zuid
SA-01, Name for	Ar Riyāḑ	Riyad
SA-02, Name for	Makkah al Mukarramah	Mekka
SA-03, Name for	Al Madīnah al Munawwarah	Medina
SA-04, Name for	Ash Sharqīyah	Ash Sharqiyah
SA-05, Name for	Al Qaşīm	Al Qasim
SA-06, Name for	Ḩā'il	Hail
SA-07, Name for	Tabūk	Tabuk
SA-08, Name for	Al Ḩudūd ash Shamālīyah	Al Hudud ash Shamaliyah
SA-09, Name for	Jāzān	Jizan
SA-10, Name for	Najrān	Najran
SA-11, Name for	Al Bāḩah	Al Bahah
SA-12, Name for	Al Jawf	Al Jawf
SA-14, Name for	'Asīr	Asir
SB-CE, Name for	Central	Central
SB-CH, Name for	Choiseul	Choiseul
SB-CT, Name for	Capital Territory (Honiara)	Honiara, Hoofdstedelijk Gewest
SB-GU, Name for	Guadalcanal	Guadalcanal
SB-IS, Name for	Isabel	Isabel
SB-MK, Name for	Makira-Ulawa	Makira
SB-ML, Name for	Malaita	Malaita
SB-RB, Name for	Rennell and Bellona	Rennell-Bellona
SB-TE, Name for	Temotu	Temotu
SB-WE, Name for	Western	Western
SC-01, Name for	Anse aux Pins	Anse aux Pins
SC-02, Name for	Anse Boileau	Anse Boileau
SC-03, Name for	Anse Etoile	Anse Etoile
SC-04, Name for	Au Cap	Au Cap
SC-05, Name for	Anse Royale	Anse Royale
SC-06, Name for	Baie Lazare	Baie Lazare
SC-07, Name for	Baie Sainte Anne	Baie Sainte Anne
SC-08, Name for	Beau Vallon	Beau Vallon
SC-09, Name for	Bel Air	Bel Air
SC-10, Name for	Bel Ombre	Bel Ombre
SC-11, Name for	Cascade	Cascade
SC-12, Name for	Glacis	Glacis
SC-13, Name for	Grand Anse Mahe	Grand' Anse Mahé
SC-14, Name for	Grand Anse Praslin	Grand' Anse Praslin
SC-15, Name for	La Digue	La Digue
SC-16, Name for	English River	La Riviere Anglaise
SC-17, Name for	Mont Buxton	Mont Buxton
SC-18, Name for	Mont Fleuri	Mont Fleuri
SC-19, Name for	Plaisance	Plaisance
SC-20, Name for	Pointe Larue	Pointe La Rue
SC-21, Name for	Port Glaud	Port Glaud
SC-22, Name for	Saint Louis	Saint Louis
SC-23, Name for	Takamaka	Takamaka
SC-24, Name for	Les Mamelles	Les Mamelles
SC-25, Name for	Roche Caiman	Roche Caiman
SC-26, Name for	Ile Perseverance I	Ile Perseverance I
SC-27, Name for	Ile Perseverance II	Ile Perseverance II
SD-DC, Name for	Central Darfur	Centraal-Darfoer
SD-DE, Name for	East Darfur	Oost-Darfoer
SD-DN, Name for	North Darfur	Noord-Darfoer
SD-DS, Name for	South Darfur	Zuid-Darfoer
SD-DW, Name for	West Darfur	West-Darfoer
SD-GD, Name for	Gedaref	Al-Qadarif
SD-GK, Name for	West Kordofan	West-Kordofan
SD-GZ, Name for	Gezira	Al-Jazirah
SD-KA, Name for	Kassala	Kassala
SD-KH, Name for	Khartoum	Khartoem
SD-KN, Name for	North Kordofan	Noord-Kordofan
SD-KS, Name for	South Kordofan	Zuid-Kordofan
SD-NB, Name for	Blue Nile	Blauwe Nijl
SD-NO, Name for	Northern	Northern
SD-NR, Name for	River Nile	Nijl
SD-NW, Name for	White Nile	Witte Nijl
SD-RS, Name for	Red Sea	Rode zee
SD-SI, Name for	Sennar	Sennar
SE-AB, Name for	Stockholms län [SE-01]	Stockholms län
SE-AC, Name for	Västerbottens län [SE-24]	Västerbottens län
SE-BD, Name for	Norrbottens län [SE-25]	Norrbottens län
SE-C, Name for	Uppsala län [SE-03]	Uppsala län
SE-D, Name for	Södermanlands län [SE-04]	Södermanlands län
SE-E, Name for	Östergötlands län [SE-05]	Östergötlands län
SE-F, Name for	Jönköpings län [SE-06]	Jönköpings län
SE-G, Name for	Kronobergs län [SE-07]	Kronobergs län
SE-H, Name for	Kalmar län [SE-08]	Kalmar län
SE-I, Name for	Gotlands län [SE-09]	Gotlands län
SE-K, Name for	Blekinge län [SE-10]	Blekinge län
SE-M, Name for	Skåne län [SE-12]	Skåne län
SE-N, Name for	Hallands län [SE-13]	Hallands län
SE-O, Name for	Västra Götalands län [SE-14]	Västra Götalands län
SE-S, Name for	Värmlands län [SE-17]	Värmlands län
SE-T, Name for	Örebro län [SE-18]	Örebro län
SE-U, Name for	Västmanlands län [SE-19]	Västmanlands län
SE-W, Name for	Dalarnas län [SE-20]	Dalarnas län
SE-X, Name for	Gävleborgs län [SE-21]	Gävleborgs län
SE-Y, Name for	Västernorrlands län [SE-22]	Västernorrlands län
SE-Z, Name for	Jämtlands län [SE-23]	Jämtlands län
SG-01, Name for	Central Singapore	Singapore-Centrale-Regio
SG-02, Name for	North East	Noord-Oost
SG-03, Name for	North West	Noord-West
SG-04, Name for	South East	Zuid-Oost
SG-05, Name for	South West	Zuid-West
SH-AC, Name for	Ascension	Ascension
SH-HL, Name for	Saint Helena	Sint Helena
SH-TA, Name for	Tristan da Cunha	Tristan da Cunha
SI-001, Name for	Ajdovščina	Ajdovscina
SI-002, Name for	Beltinci	Beltinci
SI-003, Name for	Bled	Bled
SI-004, Name for	Bohinj	Bohinj
SI-005, Name for	Borovnica	Borovnica
SI-006, Name for	Bovec	Bovec
SI-007, Name for	Brda	Brda
SI-008, Name for	Brezovica	Brezovica
SI-009, Name for	Brežice	Brezica
SI-010, Name for	Tišina	Tisina
SI-011, Name for	Celje	Celje
SI-012, Name for	Cerklje na Gorenjskem	Cerklje na Gorenjskem
SI-013, Name for	Cerknica	Cerknica
SI-014, Name for	Cerkno	Cerkno
SI-015, Name for	Črenšovci	Crensovci
SI-016, Name for	Črna na Koroškem	Crna na Koroskem
SI-017, Name for	Črnomelj	Crnomelj
SI-018, Name for	Destrnik	Destrnik
SI-019, Name for	Divača	Divaca
SI-020, Name for	Dobrepolje	Dobrepolje
SI-021, Name for	Dobrova-Polhov Gradec	Dobrova-Polhov Gradec
SI-022, Name for	Dol pri Ljubljani	Dol pri Ljubljani
SI-023, Name for	Domžale	Domzale
SI-024, Name for	Dornava	Dornava
SI-025, Name for	Dravograd	Dravograd
SI-026, Name for	Duplek	Duplek
SI-027, Name for	Gorenja vas-Poljane	Gorenja vas-Poljane
SI-028, Name for	Gorišnica	Gorsnica
SI-029, Name for	Gornja Radgona	Gornja Radgona
SI-030, Name for	Gornji Grad	Gornji Grad
SI-031, Name for	Gornji Petrovci	Gornji Petrovci
SI-032, Name for	Grosuplje	Grosuplje
SI-033, Name for	Šalovci	Salovci
SI-034, Name for	Hrastnik	Hrastnik
SI-035, Name for	Hrpelje-Kozina	Hrpelje-Kozina
SI-036, Name for	Idrija	Idrija
SI-037, Name for	Ig	Ig
SI-038, Name for	Ilirska Bistrica	Ilirska Bistrica
SI-039, Name for	Ivančna Gorica	Ivancna Gorica
SI-040, Name for	Izola	Izola
SI-041, Name for	Jesenice	Jesenice
SI-042, Name for	Juršinci	Jursinci
SI-043, Name for	Kamnik	Kamnik
SI-044, Name for	Kanal	Kanal
SI-045, Name for	Kidričevo	Kidricevo
SI-046, Name for	Kobarid	Kobarid
SI-047, Name for	Kobilje	Kobilje
SI-048, Name for	Kočevje	Kočevje
SI-049, Name for	Komen	Komen
SI-050, Name for	Koper	Koper
SI-051, Name for	Kozje	Kozje
SI-052, Name for	Kranj	Kranj
SI-053, Name for	Kranjska Gora	Kranjska Gora
SI-054, Name for	Krško	Krsko
SI-055, Name for	Kungota	Kungota
SI-056, Name for	Kuzma	Kuzma
SI-057, Name for	Laško	Lasko
SI-058, Name for	Lenart	Lenart
SI-059, Name for	Lendava	Lendava
SI-060, Name for	Litija	Litija
SI-061, Name for	Ljubljana	Ljubljana
SI-062, Name for	Ljubno	Ljubno
SI-063, Name for	Ljutomer	Ljutomer
SI-064, Name for	Logatec	Logatec
SI-065, Name for	Loška dolina	Loska dolina
SI-066, Name for	Loški Potok	Loski Potok
SI-067, Name for	Luče	Luce
SI-068, Name for	Lukovica	Lukovica
SI-069, Name for	Majšperk	Majsperk
SI-070, Name for	Maribor	Maribor
SI-071, Name for	Medvode	Medvode
SI-072, Name for	Mengeš	Menges
SI-073, Name for	Metlika	Metlika
SI-074, Name for	Mežica	Mezica
SI-075, Name for	Miren-Kostanjevica	Miren-Kostanjevica
SI-076, Name for	Mislinja	Mislinja
SI-077, Name for	Moravče	Moravce
SI-078, Name for	Moravske Toplice	Moravske Toplice
SI-079, Name for	Mozirje	Mozirje
SI-080, Name for	Murska Sobota	Murska Sobota
SI-081, Name for	Muta	Muta
SI-082, Name for	Naklo	Naklo
SI-083, Name for	Nazarje	Nazarje
SI-084, Name for	Nova Gorica	Nova Gorica
SI-085, Name for	Novo Mesto	Novo mesto
SI-086, Name for	Odranci	Odranci
SI-087, Name for	Ormož	Ormoz
SI-088, Name for	Osilnica	Osilnica
SI-089, Name for	Pesnica	Pesnica
SI-090, Name for	Piran	Piran
SI-091, Name for	Pivka	Pivka
SI-092, Name for	Podčetrtek	Podcetrtek
SI-093, Name for	Podvelka	Podvelka
SI-094, Name for	Postojna	Postojna
SI-095, Name for	Preddvor	Preddvor
SI-096, Name for	Ptuj	Ptuj
SI-097, Name for	Puconci	Puconci
SI-098, Name for	Rače-Fram	Race-Fram
SI-099, Name for	Radeče	Radece
SI-100, Name for	Radenci	Radenci
SI-101, Name for	Radlje ob Dravi	Radlje ob Dravi
SI-102, Name for	Radovljica	Radovljica
SI-103, Name for	Ravne na Koroškem	Ravne na Koroskem
SI-104, Name for	Ribnica	Ribnica
SI-105, Name for	Rogašovci	Rogasovci
SI-106, Name for	Rogaška Slatina	Rogaska Slatina
SI-107, Name for	Rogatec	Rogatec
SI-108, Name for	Ruše	Ruse
SI-109, Name for	Semič	Semic
SI-110, Name for	Sevnica	Sevnica
SI-111, Name for	Sežana	Sezana
SI-112, Name for	Slovenj Gradec	Slovenj Gradec
SI-113, Name for	Slovenska Bistrica	Slovenska Bistrica
SI-114, Name for	Slovenske Konjice	Slovenske Konjice
SI-115, Name for	Starše	Starče
SI-116, Name for	Sveti Jurij ob Ščavnici	Sveti Jurij
SI-117, Name for	Šenčur	Sencur
SI-118, Name for	Šentilj	Sentilj
SI-119, Name for	Šentjernej	Sentjernej
SI-120, Name for	Šentjur	Šentjur
SI-121, Name for	Škocjan	Skocjan
SI-122, Name for	Škofja Loka	Skofja Loka
SI-123, Name for	Škofljica	Skoftjica
SI-124, Name for	Šmarje pri Jelšah	Smarje pri Jelsah
SI-125, Name for	Šmartno ob Paki	Smartno ob Paki
SI-126, Name for	Šoštanj	Sostanj
SI-127, Name for	Štore	Store
SI-128, Name for	Tolmin	Tolmin
SI-129, Name for	Trbovlje	Trbovje
SI-130, Name for	Trebnje	Trebnje
SI-131, Name for	Tržič	Trzic
SI-132, Name for	Turnišče	Turnisce
SI-133, Name for	Velenje	Velenje
SI-134, Name for	Velike Lašče	Velika Lasce
SI-135, Name for	Videm	Videm
SI-136, Name for	Vipava	Vipava
SI-137, Name for	Vitanje	Vitanje
SI-138, Name for	Vodice	Vodice
SI-139, Name for	Vojnik	Vojnik
SI-140, Name for	Vrhnika	Vrhnika
SI-141, Name for	Vuzenica	Vuzenica
SI-142, Name for	Zagorje ob Savi	Zagorje ob Savi
SI-143, Name for	Zavrč	Zavrc
SI-144, Name for	Zreče	Zrece
SI-146, Name for	Železniki	Zelezniki
SI-147, Name for	Žiri	Ziri
SI-148, Name for	Benedikt	Benedikt
SI-149, Name for	Bistrica ob Sotli	Bistrica ob Sotli
SI-150, Name for	Bloke	Bloke
SI-151, Name for	Braslovče	Braslovce
SI-152, Name for	Cankova	Cankova
SI-153, Name for	Cerkvenjak	Cerkvenjak
SI-154, Name for	Dobje	Dobje
SI-155, Name for	Dobrna	Dobrna
SI-156, Name for	Dobrovnik	Dobrovnik
SI-157, Name for	Dolenjske Toplice	Dolenjske Toplice
SI-158, Name for	Grad	Grad
SI-159, Name for	Hajdina	Hajdina
SI-160, Name for	Hoče-Slivnica	Hoce-Slivnica
SI-161, Name for	Hodoš	Hodoš
SI-162, Name for	Horjul	Jorjul
SI-163, Name for	Jezersko	Jezersko
SI-164, Name for	Komenda	Komenda
SI-165, Name for	Kostel	Kostel
SI-166, Name for	Križevci	Krizevci
SI-167, Name for	Lovrenc na Pohorju	Lovrenc na Pohorju
SI-168, Name for	Markovci	Markovci
SI-169, Name for	Miklavž na Dravskem polju	Miklavz na Dravskern polju
SI-170, Name for	Mirna Peč	Mirna Pec
SI-171, Name for	Oplotnica	Oplotnica
SI-172, Name for	Podlehnik	Podlehnik
SI-173, Name for	Polzela	Polzela
SI-174, Name for	Prebold	Prebold
SI-175, Name for	Prevalje	Prevalje
SI-176, Name for	Razkrižje	Razkrizje
SI-177, Name for	Ribnica na Pohorju	Ribnica na Pohorju
SI-178, Name for	Selnica ob Dravi	Selnica ob Dravi
SI-179, Name for	Sodražica	Sodrazica
SI-180, Name for	Solčava	Solcava
SI-181, Name for	Sveta Ana	Sveta Ana
SI-182, Name for	Sveti Andraž v Slovenskih goricah	Sveta Andraž v Slovenskih Goricah
SI-183, Name for	Šempeter-Vrtojba	Sempeter-Vrtojba
SI-184, Name for	Tabor	Tabor
SI-185, Name for	Trnovska Vas	Trnovska vas
SI-186, Name for	Trzin	Trzin
SI-187, Name for	Velika Polana	Velika Polana
SI-188, Name for	Veržej	Verzej
SI-189, Name for	Vransko	Vransko
SI-190, Name for	Žalec	Žalec
SI-191, Name for	Žetale	Zetale
SI-192, Name for	Žirovnica	Zirovnica
SI-193, Name for	Žužemberk	Zuzemberk
SI-194, Name for	Šmartno pri Litiji	Smartno pri Litiji
SI-195, Name for	Apače	Apače
SI-196, Name for	Cirkulane	Cirkulane
SI-197, Name for	Kosanjevica na Krki	Kosanjevica na Krki
SI-198, Name for	Makole	Makole
SI-199, Name for	Mokronog-Trebelno	Mokronog-Trebelno
SI-200, Name for	Poljčane	Poljčane
SI-201, Name for	Renče-Vogrsko	Renče-Vogrsko
SI-202, Name for	Središče ob Dravi	Središče ob Dravi
SI-203, Name for	Straža	Straža
SI-204, Name for	Sveta Trojica v Slovenskih goricah	Sveta Trojica v Slovenskih Goricah
SI-205, Name for	Sveti Tomaž	Sveti Tomaž
SI-206, Name for	Šmarješke Toplice	Šmarjeske Topliče
SI-207, Name for	Gorje	Gorje
SI-208, Name for	Log-Dragomer	Log-Dragomer
SI-209, Name for	Rečica ob Savinji	Rečica ob Savinji
SI-210, Name for	Sveti Jurij v Slovenskih goricah	Sveti Jurij v Slovenskih Goricah
SI-211, Name for	Šentrupert	Šentrupert
SI-212, Name for	Mirna	Mirna Pec
SI-213, Name for	Ankaran	Ankara
SK-BC, Name for	Banskobystrický kraj	Banská Bystrica, Regio
SK-BL, Name for	Bratislavský kraj	Bratislava, Regio
SK-KI, Name for	Košický kraj	Košice, Regio
SK-NI, Name for	Nitriansky kraj	Nitra, Regio
SK-PV, Name for	Prešovský kraj	Prešov, Regio
SK-TA, Name for	Trnavský kraj	Trnava, Regio
SK-TC, Name for	Trenčiansky kraj	Trenčín, Regio
SK-ZI, Name for	Žilinský kraj	Žilina, Regio
SL-E, Name for	Eastern	Oost
SL-N, Name for	Northern	Northern
SL-NW, Name for	North Western	Noord-West
SL-S, Name for	Southern	Zuid
SL-W, Name for	Western Area (Freetown)	Westelijk Gebied (Freetown)
SM-01, Name for	Acquaviva	Acquaviva
SM-02, Name for	Chiesanuova	Chiesanuova
SM-03, Name for	Domagnano	Domagnano
SM-04, Name for	Faetano	Faetano
SM-05, Name for	Fiorentino	Fiorentino
SM-06, Name for	Borgo Maggiore	Borgo Maggiore
SM-07, Name for	Città di San Marino	San Marino
SM-08, Name for	Montegiardino	Monte Giardino
SM-09, Name for	Serravalle	Serravalle
SN-DB, Name for	Diourbel	Diourbel
SN-DK, Name for	Dakar	Dakar
SN-FK, Name for	Fatick	Fatick
SN-KA, Name for	Kaffrine	Kaffrine
SN-KD, Name for	Kolda	Kolda
SN-KE, Name for	Kédougou	Kédougou
SN-KL, Name for	Kaolack	Kaolack
SN-LG, Name for	Louga	Louga
SN-MT, Name for	Matam	Matam
SN-SE, Name for	Sédhiou	Sédhiou
SN-SL, Name for	Saint-Louis	Saint-Louis
SN-TC, Name for	Tambacounda	Tambacounda
SN-TH, Name for	Thiès	Thiès
SN-ZG, Name for	Ziguinchor	Ziguinchor
SO-AW, Name for	Awdal	Awdal
SO-BK, Name for	Bakool	Bakool
SO-BN, Name for	Banaadir	Banaadir
SO-BR, Name for	Bari	Bari
SO-BY, Name for	Bay	Bay
SO-GA, Name for	Galguduud	Galguduud
SO-GE, Name for	Gedo	Gedo
SO-HI, Name for	Hiiraan	Hiiraan
SO-JD, Name for	Jubbada Dhexe	Midden-Juba
SO-JH, Name for	Jubbada Hoose	Neder-Juba
SO-MU, Name for	Mudug	Mudug
SO-NU, Name for	Nugaal	Nugaal
SO-SA, Name for	Sanaag	Sanaag
SO-SD, Name for	Shabeellaha Dhexe	Midden-Shabelle
SO-SH, Name for	Shabeellaha Hoose	Neder-Shabelle
SO-SO, Name for	Sool	Sool
SO-TO, Name for	Togdheer	Togdheer
SO-WO, Name for	Woqooyi Galbeed	Woqooyi Galbeed
SR-BR, Name for	Brokopondo	Brokopondo
SR-CM, Name for	Commewijne	Commewijne
SR-CR, Name for	Coronie	Coronie
SR-MA, Name for	Marowijne	Marowijne
SR-NI, Name for	Nickerie	Nickerie
SR-PM, Name for	Paramaribo	Paramaribo
SR-PR, Name for	Para	Para
SR-SA, Name for	Saramacca	Saramacca
SR-SI, Name for	Sipaliwini	Sipaliwini
SR-WA, Name for	Wanica	Wanica
SS-BN, Name for	Northern Bahr el Ghazal	Northern Bahr el Ghazal
SS-BW, Name for	Western Bahr el Ghazal	Western Bahr el Ghazal
SS-EC, Name for	Central Equatoria	Centraal-Equatoria
SS-EE, Name for	Eastern Equatoria	Oost-Equatoria
SS-EW, Name for	Western Equatoria	West-Equatoria
SS-JG, Name for	Jonglei	Jonquali
SS-LK, Name for	Lakes	Meren
SS-NU, Name for	Upper Nile	Opper-Nijl
SS-UY, Name for	Unity	Eenheid
SS-WR, Name for	Warrap	Warab
ST-01, Name for	Água Grande	Água Grande
ST-02, Name for	Cantagalo	Cantagalo
ST-03, Name for	Caué	Caué
ST-04, Name for	Lembá	Lembá
ST-05, Name for	Lobata	Lobata
ST-06, Name for	Mé-Zóchi	Mé-Zóchi
ST-P, Name for	Príncipe	Principe
SV-AH, Name for	Ahuachapán	Ahuachapán
SV-CA, Name for	Cabañas	Cabañas
SV-CH, Name for	Chalatenango	Chalatenango
SV-CU, Name for	Cuscatlán	Cuscatlán
SV-LI, Name for	La Libertad	La Libertad
SV-MO, Name for	Morazán	Morazán
SV-PA, Name for	La Paz	La Paz
SV-SA, Name for	Santa Ana	Santa Ana
SV-SM, Name for	San Miguel	San Miguel
SV-SO, Name for	Sonsonate	Sonsonate
SV-SS, Name for	San Salvador	San Salvador
SV-SV, Name for	San Vicente	San Vicente
SV-UN, Name for	La Unión	La Unión
SV-US, Name for	Usulután	Usulután
SY-DI, Name for	Dimashq	Dimashq
SY-DR, Name for	Dar'ā	Dera
SY-DY, Name for	Dayr az Zawr	Dayr az Zawr
SY-HA, Name for	Al Ḩasakah	Al-Hasakah
SY-HI, Name for	Ḩimş	Homs
SY-HL, Name for	Ḩalab	Aleppo
SY-HM, Name for	Ḩamāh	Hama
SY-ID, Name for	Idlib	Idlib
SY-LA, Name for	Al Lādhiqīyah	Latakia
SY-QU, Name for	Al Qunayţirah	Quneitra;Al Quneitra
SY-RA, Name for	Ar Raqqah	Ar-Raqqah
SY-RD, Name for	Rīf Dimashq	Rif Dimashq
SY-SU, Name for	As Suwaydā'	As-Suwayda
SY-TA, Name for	Ţarţūs	Tartous; Tartus; Tartoes
SZ-HH, Name for	Hhohho	Hhohho
SZ-LU, Name for	Lubombo	Lubombo
SZ-MA, Name for	Manzini	Manzini
SZ-SH, Name for	Shiselweni	Shiselweni
TD-BA, Name for	Al Baţḩā’	Batha
TD-BG, Name for	Bahr el Ghazal	Bahr el Ghazal
TD-BO, Name for	Borkou	Borkou
TD-CB, Name for	Chari-Baguirmi	Chari-Baguirmi
TD-EE, Name for	Ennedi-Est	Ennedi Est
TD-EO, Name for	Ennedi-Ouest	Ennedi Ouest
TD-GR, Name for	Guéra	Guéra
TD-HL, Name for	Hadjer Lamis	Hadjer-Lamis
TD-KA, Name for	Kanem	Kanem
TD-LC, Name for	Al Buḩayrah	Al Buhayrah
TD-LO, Name for	Logone-Occidental	Logone Occidental
TD-LR, Name for	Logone-Oriental	Logone Oriental
TD-MA, Name for	Mandoul	Mandoul
TD-MC, Name for	Moyen-Chari	Moyen-Chari
TD-ME, Name for	Mayo-Kebbi-Est	Mayo-Kebbi Est
TD-MO, Name for	Mayo-Kebbi-Ouest	Mayo-Kebbi Ouest
TD-ND, Name for	Madīnat Injamīnā	Ndjamena
TD-OD, Name for	Ouaddaï	Ouaddaï
TD-SA, Name for	Salamat	Salamat
TD-SI, Name for	Sila	Sila
TD-TA, Name for	Tandjilé	Tandjilé
TD-TI, Name for	Tibastī	Tibesti
TD-WF, Name for	Wadi Fira	Wadi Fira
TG-C, Name for	Centrale	Central
TG-K, Name for	Kara	Karas
TG-M, Name for	Maritime (Région)	Fromager, Regio
TG-P, Name for	Plateaux	Plateaux
TG-S, Name for	Savanes	Savanes
TH-10, Name for	Krung Thep Maha Nakhon	Krung Thep Maha Nakhon Bangkok
TH-11, Name for	Samut Prakan	Samut Prakan
TH-12, Name for	Nonthaburi	Nonthaburi
TH-13, Name for	Pathum Thani	Pathum Thani
TH-14, Name for	Phra Nakhon Si Ayutthaya	Phra Nakhon Si Ayutthaya
TH-15, Name for	Ang Thong	Ang Thong
TH-16, Name for	Lop Buri	Lop Buri
TH-17, Name for	Sing Buri	Sing Buri
TH-18, Name for	Chai Nat	Chai Nat
TH-19, Name for	Saraburi	Saraburi
TH-20, Name for	Chon Buri	Chon Buri
TH-21, Name for	Rayong	Rayong
TH-22, Name for	Chanthaburi	Chanthaburi
TH-23, Name for	Trat	Trat
TH-24, Name for	Chachoengsao	Chachoengsao
TH-25, Name for	Prachin Buri	Prachin Buri
TH-26, Name for	Nakhon Nayok	Nakhon Nayok
TH-27, Name for	Sa Kaeo	Sa Kaeo
TH-30, Name for	Nakhon Ratchasima	Nakhon Ratchasima
TH-31, Name for	Buri Ram	Buri Ram
TH-32, Name for	Surin	Surin
TH-33, Name for	Si Sa Ket	Si Sa Ket
TH-34, Name for	Ubon Ratchathani	Ubon Ratchathani
TH-35, Name for	Yasothon	Yasothon
TH-36, Name for	Chaiyaphum	Chaiyaphum
TH-37, Name for	Amnat Charoen	Amnat Charoen
TH-38, Name for	Bueng Kan	Stoeng Treng
TH-39, Name for	Nong Bua Lam Phu	Nong Bua Lam Phu
TH-40, Name for	Khon Kaen	Khon Kaen
TH-41, Name for	Udon Thani	Udon Thani
TH-42, Name for	Loei	Loei
TH-43, Name for	Nong Khai	Nong Khai
TH-44, Name for	Maha Sarakham	Maha Sarakham
TH-45, Name for	Roi Et	Roi Et
TH-46, Name for	Kalasin	Kalasin
TH-47, Name for	Sakon Nakhon	Sakon Nakhon
TH-48, Name for	Nakhon Phanom	Nakhon Phanom
TH-49, Name for	Mukdahan	Mukdahan
TH-50, Name for	Chiang Mai	Chiang Mai
TH-51, Name for	Lamphun	Lamphun
TH-52, Name for	Lampang	Lampang
TH-53, Name for	Uttaradit	Uttaradit
TH-54, Name for	Phrae	Phrae
TH-55, Name for	Nan	Nan
TH-56, Name for	Phayao	Phayao
TH-57, Name for	Chiang Rai	Chiang Rai
TH-58, Name for	Mae Hong Son	Mae Hong Son
TH-60, Name for	Nakhon Sawan	Nakhon Sawan
TH-61, Name for	Uthai Thani	Uthai Thani
TH-62, Name for	Kamphaeng Phet	Kamphaeng Phet
TH-63, Name for	Tak	Tak
TH-64, Name for	Sukhothai	Sukhothai
TH-65, Name for	Phitsanulok	Phitsanulok
TH-66, Name for	Phichit	Phichit
TH-67, Name for	Phetchabun	Phetchabun
TH-70, Name for	Ratchaburi	Ratchaburi
TH-71, Name for	Kanchanaburi	Kanchanaburi
TH-72, Name for	Suphan Buri	Suphan Buri
TH-73, Name for	Nakhon Pathom	Nakhon Pathom
TH-74, Name for	Samut Sakhon	Samut Sakhon
TH-75, Name for	Samut Songkhram	Samut Songkhram
TH-76, Name for	Phetchaburi	Phetchaburi
TH-77, Name for	Prachuap Khiri Khan	Prachuap Khiri Khan
TH-80, Name for	Nakhon Si Thammarat	Nakhon Si Thammarat
TH-81, Name for	Krabi	Krabi
TH-82, Name for	Phangnga	Phangnga
TH-83, Name for	Phuket	Phuket
TH-84, Name for	Surat Thani	Surat Thani
TH-85, Name for	Ranong	Ranong
TH-86, Name for	Chumphon	Chumphon
TH-90, Name for	Songkhla	Songkhla
TH-91, Name for	Satun	Satun
TH-92, Name for	Trang	Trang
TH-93, Name for	Phatthalung	Phatthalung
TH-94, Name for	Pattani	Pattani
TH-95, Name for	Yala	Yala
TH-96, Name for	Narathiwat	Narathiwat
TH-S, Name for	Phatthaya	Phatthaya
TJ-DU, Name for	Dushanbe	Doesjanbe
TJ-GB, Name for	Kŭhistoni Badakhshon	Gorno-Badachsjan
TJ-KT, Name for	Khatlon	Khatlon
TJ-RA, Name for	nohiyahoi tobei jumhurí	districten onder jurisdictie van de republiek
TJ-SU, Name for	Sughd	Sughd
TL-AL, Name for	Aileu	Aileu
TL-AN, Name for	Ainaro	Ainaro
TL-BA, Name for	Baucau	Baucau
TL-BO, Name for	Bobonaro	Bobonaro
TL-CO, Name for	Cova Lima	Cova Lima
TL-DI, Name for	Díli	Dili
TL-ER, Name for	Ermera	Ermera
TL-LA, Name for	Lautein	Lautém
TL-LI, Name for	Likisá	Liquiçá
TL-MF, Name for	Manufahi	Manufahi
TL-MT, Name for	Manatuto	Manatuto
TL-OE, Name for	Oekusi-Ambenu	Oe-Cusse Ambeno
TL-VI, Name for	Vikeke	Viqueque
TM-A, Name for	Ahal	Ahal
TM-B, Name for	Balkan	Balkan
TM-D, Name for	Daşoguz	Daşoguz
TM-L, Name for	Lebap	Lebap
TM-M, Name for	Mary	Mary
TM-S, Name for	Aşgabat	Aşgabat
TN-11, Name for	Tunis	Tunis
TN-12, Name for	L'Ariana	Ariana
TN-13, Name for	Ben Arous	Ben Arous
TN-14, Name for	La Manouba	Manouba
TN-21, Name for	Nabeul	Nabeul
TN-22, Name for	Zaghouan	Zaghouan
TN-23, Name for	Bizerte	Bizerte
TN-31, Name for	Béja	Béja
TN-32, Name for	Jendouba	Jendouba
TN-33, Name for	Le Kef	Le Kef
TN-34, Name for	Siliana	Siliana
TN-41, Name for	Kairouan	Kairouan
TN-42, Name for	Kasserine	Kasserine
TN-43, Name for	Sidi Bouzid	Sidi Bouzid
TN-51, Name for	Sousse	Sousse
TN-52, Name for	Monastir	Monastir
TN-53, Name for	Mahdia	Mahdia
TN-61, Name for	Sfax	Sfax
TN-71, Name for	Gafsa	Gafsa
TN-72, Name for	Tozeur	Tozeur
TN-73, Name for	Kébili	Kebili
TN-81, Name for	Gabès	Gabès
TN-82, Name for	Médenine	Medenine
TN-83, Name for	Tataouine	Tataouine
TO-01, Name for	'Eua	'Eua
TO-02, Name for	Ha'apai	Ha'apai
TO-03, Name for	Niuas	Niuas
TO-04, Name for	Tongatapu	Tongatapu
TO-05, Name for	Vava'u	Vava'u
TR-01, Name for	Adana	Adana
TR-02, Name for	Adıyaman	Adıyaman
TR-03, Name for	Afyonkarahisar	Afyonkarahisar
TR-04, Name for	Ağrı	Ağrı
TR-05, Name for	Amasya	Amasya
TR-06, Name for	Ankara	Ankara
TR-07, Name for	Antalya	Antalya
TR-08, Name for	Artvin	Artvin
TR-09, Name for	Aydın	Aydin
TR-10, Name for	Balıkesir	Balikesir
TR-11, Name for	Bilecik	Bilecik
TR-12, Name for	Bingöl	Bingol
TR-13, Name for	Bitlis	Bitlis
TR-14, Name for	Bolu	Bolu
TR-15, Name for	Burdur	Burdur
TR-16, Name for	Bursa	Bursa
TR-17, Name for	Çanakkale	Çanakkale
TR-18, Name for	Çankırı	Çankırı
TR-19, Name for	Çorum	Çorum
TR-20, Name for	Denizli	Denizli
TR-21, Name for	Diyarbakır	Diyarbakır
TR-22, Name for	Edirne	Edirne
TR-23, Name for	Elazığ	Elazığ
TR-24, Name for	Erzincan	Erzincan
TR-25, Name for	Erzurum	Erzurum
TR-26, Name for	Eskişehir	Eskişehir
TR-27, Name for	Gaziantep	Gaziantep
TR-28, Name for	Giresun	Giresun
TR-29, Name for	Gümüşhane	Gümüşhane
TR-30, Name for	Hakkâri	Hakkâri
TR-31, Name for	Hatay	Hatay
TR-32, Name for	Isparta	Isparta
TR-33, Name for	Mersin	Mersin
TR-34, Name for	İstanbul	Istanbul
TR-35, Name for	İzmir	Izmir
TR-36, Name for	Kars	Kars
TR-37, Name for	Kastamonu	Kastamonu
TR-38, Name for	Kayseri	Kayseri
TR-39, Name for	Kırklareli	Kırklareli
TR-40, Name for	Kırşehir	Kırşehir
TR-41, Name for	Kocaeli	Kocaeli
TR-42, Name for	Konya	Konya
TR-43, Name for	Kütahya	Kütahya
TR-44, Name for	Malatya	Malatya
TR-45, Name for	Manisa	Manisa
TR-46, Name for	Kahramanmaraş	Kahramanmaraş
TR-47, Name for	Mardin	Mardin
TR-48, Name for	Muğla	Muğla
TR-49, Name for	Muş	Muş
TR-50, Name for	Nevşehir	Nevşehir
TR-51, Name for	Niğde	Niğde
TR-52, Name for	Ordu	Ordu
TR-53, Name for	Rize	Rize
TR-54, Name for	Sakarya	Sakarya
TR-55, Name for	Samsun	Samsun
TR-56, Name for	Siirt	Siirt
TR-57, Name for	Sinop	Sinop
TR-58, Name for	Sivas	Sivas
TR-59, Name for	Tekirdağ	Tekirdağ
TR-60, Name for	Tokat	Tokat
TR-61, Name for	Trabzon	Trabzon
TR-62, Name for	Tunceli	Tunceli
TR-63, Name for	Şanlıurfa	Şanlıurfa
TR-64, Name for	Uşak	Uşak
TR-65, Name for	Van	Van
TR-66, Name for	Yozgat	Yozgat
TR-67, Name for	Zonguldak	Zonguldak
TR-68, Name for	Aksaray	Aksaray
TR-69, Name for	Bayburt	Bayburt
TR-70, Name for	Karaman	Karaman
TR-71, Name for	Kırıkkale	Kırıkkale
TR-72, Name for	Batman	Batman
TR-73, Name for	Şırnak	Şırnak
TR-74, Name for	Bartın	Bartin
TR-75, Name for	Ardahan	Ardahan
TR-76, Name for	Iğdır	Iğdır
TR-77, Name for	Yalova	Yalova
TR-78, Name for	Karabük	Karabük
TR-79, Name for	Kilis	Kilis
TR-80, Name for	Osmaniye	Osmaniye
TR-81, Name for	Düzce	Düzce
TT-ARI, Name for	Arima	Arima
TT-CHA, Name for	Chaguanas	Chaguanas
TT-CTT, Name for	Couva-Tabaquite-Talparo	Couva - Tabaquite - Talparo
TT-DMN, Name for	Diego Martin	Diego Martin
TT-MRC, Name for	Mayaro-Rio Claro	Rio Claro - Mayaro
TT-PED, Name for	Penal-Debe	Penal - Debe
TT-POS, Name for	Port of Spain	Port of Spain
TT-PRT, Name for	Princes Town	Princes Town
TT-PTF, Name for	Point Fortin	Point Fortin
TT-SFO, Name for	San Fernando	San Fernando
TT-SGE, Name for	Sangre Grande	Sangre Grande
TT-SIP, Name for	Siparia	Siparia
TT-SJL, Name for	San Juan-Laventille	San Juan - Laventille
TT-TOB, Name for	Tobago	Tobago
TT-TUP, Name for	Tunapuna-Piarco	Tunapuna - Piarco
TV-FUN, Name for	Funafuti	Funafuti
TV-NIT, Name for	Niutao	Niutao
TV-NKF, Name for	Nukufetau	Nukufetau
TV-NKL, Name for	Nukulaelae	Nukulaelae
TV-NMA, Name for	Nanumea	Nanumea
TV-NMG, Name for	Nanumaga	Nanumanga
TV-NUI, Name for	Nui	Nui
TV-VAI, Name for	Vaitupu	Vaitupu
TW-CHA, Name for	Changhua	Changhua
TW-CYI, Name for	Chiayi	Chiayi
TW-CYQ, Name for	Chiayi	Chiayi
TW-HSQ, Name for	Hsinchu	Hsinchu
TW-HSZ, Name for	Hsinchu	Hsinchu
TW-HUA, Name for	Hualien	Hualien
TW-ILA, Name for	Yilan	Yilan
TW-KEE, Name for	Keelung	Keelung
TW-KHH, Name for	Kaohsiung	Kaohsiung
TW-KIN, Name for	Kinmen	Kinmen
TW-LIE, Name for	Lienchiang	Lienchiang
TW-MIA, Name for	Miaoli	Miaoli
TW-NAN, Name for	Nantou	Nantou
TW-NWT, Name for	New Taipei	Nieuw Taipei
TW-PEN, Name for	Penghu	Penghu
TW-PIF, Name for	Pingtung	Pingtung
TW-TAO, Name for	Taoyuan	Taoyuan
TW-TNN, Name for	Tainan	Tainan
TW-TPE, Name for	Taipei	Taipei
TW-TTT, Name for	Taitung	Taitung
TW-TXG, Name for	Taichung	Taichung
TW-YUN, Name for	Yunlin	Yunlin
TZ-01, Name for	Arusha	Arusha
TZ-02, Name for	Dar es Salaam	Dar es Salaam
TZ-03, Name for	Dodoma	Dodoma
TZ-04, Name for	Iringa	Iringa
TZ-05, Name for	Kagera	Kagera
TZ-06, Name for	Pemba North	Noord-Pemba
TZ-07, Name for	Zanzibar North	Noord-Zanzibar
TZ-08, Name for	Kigoma	Kigoma
TZ-09, Name for	Kilimanjaro	Kilimanjaro
TZ-10, Name for	Pemba South	Zuid-Pemba
TZ-11, Name for	Zanzibar South	Zuid-Zanzibar, Centraal- en
TZ-12, Name for	Lindi	Lindi
TZ-13, Name for	Mara	Mara
TZ-14, Name for	Mbeya	Mbeya
TZ-15, Name for	Zanzibar West	West-Zanzibar, Stedelijk- en
TZ-16, Name for	Morogoro	Morogoro
TZ-17, Name for	Mtwara	Mtwara
TZ-18, Name for	Mwanza	Mwanza
TZ-19, Name for	Coast	Pwani
TZ-20, Name for	Rukwa	Rukwa
TZ-21, Name for	Ruvuma	Ruvuma
TZ-22, Name for	Shinyanga	Shinyanga
TZ-23, Name for	Singida	Singida
TZ-24, Name for	Tabora	Tabora
TZ-25, Name for	Tanga	Tanga
TZ-26, Name for	Manyara	Manyara
TZ-27, Name for	Geita	Geita
TZ-28, Name for	Katavi	Katavi
TZ-29, Name for	Njombe	Njombe
TZ-30, Name for	Simiyu	Simiyu
TZ-31, Name for	Songwe	Songwe
UA-05, Name for	Vinnytska oblast	Vinnytsja, Provincie
UA-07, Name for	Volynska oblast	Wolynië, Provincie
UA-09, Name for	Luhanska oblast	Loehansk, Provindie
UA-12, Name for	Dnipropetrovska oblast	Dnjepropetrovsk, Provincie
UA-14, Name for	Donetska oblast	Donetsk, Provincie
UA-18, Name for	Zhytomyrska oblast	Zjytomyr, Provincie
UA-21, Name for	Zakarpatska oblast	Transkarpatië, Provincie
UA-23, Name for	Zaporizka oblast	Zaporizja, Provincie
UA-26, Name for	Ivano-Frankivska oblast	Ivano-Frankivsk, Provincie
UA-30, Name for	Kyiv	Kiev (stad)
UA-32, Name for	Kyivska oblast	Kiev, Provincie
UA-35, Name for	Kirovohradska oblast	Kirovohrad, Provincie
UA-40, Name for	Sevastopol	Sebastopol
UA-43, Name for	Avtonomna Respublika Krym	Krim, Republiek de
UA-46, Name for	Lvivska oblast	Lviv, Provincie
UA-48, Name for	Mykolaivska oblast	Mykolajiv, Provincie
UA-51, Name for	Odeska oblast	Odessa, Provincie
UA-53, Name for	Poltavska oblast	Poltava, Provincie
UA-56, Name for	Rivnenska oblast	Rivne, Provincie
UA-59, Name for	Sumska oblast	Soemy, Provincie
UA-61, Name for	Ternopilska oblast	Ternopil, Provincie
UA-63, Name for	Kharkivska oblast	Charkov, Provincie
UA-65, Name for	Khersonska oblast	Cherson, Provincie
UA-68, Name for	Khmelnytska oblast	Chmelnytsky, Provincie
UA-71, Name for	Cherkaska oblast	Tsjerkasy, Provincie
UA-74, Name for	Chernihivska oblast	Tsjernihiv, Provincie
UA-77, Name for	Chernivetska oblast	Tsjernivtsi, Provincie
UG-101, Name for	Kalangala	Kalangala
UG-102, Name for	Kampala	Kampala
UG-103, Name for	Kiboga	Kiboga
UG-104, Name for	Luwero	Luwero
UG-105, Name for	Masaka	Masaka
UG-106, Name for	Mpigi	Mpigi
UG-107, Name for	Mubende	Mubende
UG-108, Name for	Mukono	Mukono
UG-109, Name for	Nakasongola	Nakasongola
UG-110, Name for	Rakai	Rakai
UG-111, Name for	Sembabule	Sembabule
UG-112, Name for	Kayunga	Kayunga
UG-113, Name for	Wakiso	Wakiso
UG-114, Name for	Lyantonde	Lyantonde
UG-115, Name for	Mityana	Mityana
UG-116, Name for	Nakaseke	Nakaseke
UG-117, Name for	Buikwe	NOG NIET VERTAALD
UG-118, Name for	Bukomansibi	NOG NIET VERTAALD
UG-119, Name for	Butambala	Butaleja
UG-120, Name for	Buvuma	Ruvuma
UG-121, Name for	Gomba	Zomba
UG-122, Name for	Kalungu	Kasungu
UG-123, Name for	Kyankwanzi	NOG NIET VERTAALD
UG-124, Name for	Lwengo	Bengo
UG-125, Name for	Kyotera	Kyoto
UG-126, Name for	Kasanda	Kandal
UG-201, Name for	Bugiri	Bugiri
UG-202, Name for	Busia	Busia
UG-203, Name for	Iganga	Iganga
UG-204, Name for	Jinja	Jinja
UG-205, Name for	Kamuli	Kamuli
UG-206, Name for	Kapchorwa	Kapchorwa
UG-207, Name for	Katakwi	Katakwi
UG-208, Name for	Kumi	Kumi
UG-209, Name for	Mbale	Mbale
UG-210, Name for	Pallisa	Pallisa
UG-211, Name for	Soroti	Soroti
UG-212, Name for	Tororo	Tororo
UG-213, Name for	Kaberamaido	Kaberamaido
UG-214, Name for	Mayuge	Mayuge
UG-215, Name for	Sironko	Sironko
UG-216, Name for	Amuria	Amuria
UG-217, Name for	Budaka	Budaka
UG-218, Name for	Bududa	Bududa
UG-219, Name for	Bukedea	Bukedea
UG-220, Name for	Bukwo	Bukwa
UG-221, Name for	Butaleja	Butaleja
UG-222, Name for	Kaliro	Kaliro
UG-223, Name for	Manafwa	Manafwa
UG-224, Name for	Namutumba	Namutumba
UG-225, Name for	Bulambuli	NOG NIET VERTAALD
UG-226, Name for	Buyende	Mubende
UG-227, Name for	Kibuku	NOG NIET VERTAALD
UG-228, Name for	Kween	NOG NIET VERTAALD
UG-229, Name for	Luuka	NOG NIET VERTAALD
UG-230, Name for	Namayingo	Namangan
UG-231, Name for	Ngora	Zagora
UG-232, Name for	Serere	NOG NIET VERTAALD
UG-233, Name for	Butebo	Butel
UG-234, Name for	Namisindwa	NOG NIET VERTAALD
UG-235, Name for	Bugweri	NOG NIET VERTAALD
UG-236, Name for	Kapelebyong	NOG NIET VERTAALD
UG-237, Name for	Kalaki	Kalasin
UG-301, Name for	Adjumani	Adjumani
UG-302, Name for	Apac	Apac
UG-303, Name for	Arua	Arua
UG-304, Name for	Gulu	Gulu
UG-305, Name for	Kitgum	Kitgum
UG-306, Name for	Kotido	Kotido
UG-307, Name for	Lira	Lira
UG-308, Name for	Moroto	Moroto
UG-309, Name for	Moyo	Moyo
UG-310, Name for	Nebbi	Nebbi
UG-311, Name for	Nakapiripirit	Nakapiripirit
UG-312, Name for	Pader	Pader
UG-313, Name for	Yumbe	Yumbe
UG-314, Name for	Abim	Abim
UG-315, Name for	Amolatar	Amolatar
UG-316, Name for	Amuru	Amuru
UG-317, Name for	Dokolo	Dokolo
UG-318, Name for	Kaabong	Kaabong
UG-319, Name for	Koboko	Koboko
UG-320, Name for	Maracha	Maracha
UG-321, Name for	Oyam	Oyam
UG-322, Name for	Agago	NOG NIET VERTAALD
UG-323, Name for	Alebtong	NOG NIET VERTAALD
UG-324, Name for	Amudat	NOG NIET VERTAALD
UG-325, Name for	Kole	NOG NIET VERTAALD
UG-326, Name for	Lamwo	NOG NIET VERTAALD
UG-327, Name for	Napak	NOG NIET VERTAALD
UG-328, Name for	Nwoya	NOG NIET VERTAALD
UG-329, Name for	Otuke	NOG NIET VERTAALD
UG-330, Name for	Zombo	Zomba
UG-331, Name for	Omoro	NOG NIET VERTAALD
UG-332, Name for	Pakwach	NOG NIET VERTAALD
UG-333, Name for	Kwania	Pwani
UG-334, Name for	Nabilatuk	NOG NIET VERTAALD
UG-335, Name for	Karenga	Yatenga
UG-336, Name for	Madi-Okollo	NOG NIET VERTAALD
UG-337, Name for	Obongi	Kaabong
UG-401, Name for	Bundibugyo	Bundibugyo
UG-402, Name for	Bushenyi	Bushenyi
UG-403, Name for	Hoima	Hoima
UG-404, Name for	Kabale	Kabale
UG-405, Name for	Kabarole	Kabarole
UG-406, Name for	Kasese	Kasese
UG-407, Name for	Kibaale	Kibaale
UG-408, Name for	Kisoro	Kisoro
UG-409, Name for	Masindi	Masindi
UG-410, Name for	Mbarara	Mbarara
UG-411, Name for	Ntungamo	Ntungamo
UG-412, Name for	Rukungiri	Rukungiri
UG-413, Name for	Kamwenge	Kamwenge
UG-414, Name for	Kanungu	Kanungu
UG-415, Name for	Kyenjojo	Kyenjojo
UG-416, Name for	Buliisa	Bulisa
UG-417, Name for	Ibanda	Ibanda
UG-418, Name for	Isingiro	Isingiro
UG-419, Name for	Kiruhura	Kiruhura
UG-420, Name for	Buhweju	NOG NIET VERTAALD
UG-421, Name for	Kiryandongo	Bayanhongor
UG-422, Name for	Kyegegwa	NOG NIET VERTAALD
UG-423, Name for	Mitooma	NOG NIET VERTAALD
UG-424, Name for	Ntoroko	NOG NIET VERTAALD
UG-425, Name for	Rubirizi	NOG NIET VERTAALD
UG-426, Name for	Sheema	NOG NIET VERTAALD
UG-427, Name for	Kagadi	Kgalagadi
UG-428, Name for	Kakumiro	NOG NIET VERTAALD
UG-429, Name for	Rubanda	Ibanda
UG-430, Name for	Bunyangabu	Shinyanga
UG-431, Name for	Rukiga	NOG NIET VERTAALD
UG-432, Name for	Kikuube	NOG NIET VERTAALD
UG-433, Name for	Kazo	NOG NIET VERTAALD
UG-434, Name for	Kitagwenda	Ohangwena
UG-435, Name for	Rwampara	Gampaha
UG-C, Name for	Central	Central
UG-E, Name for	Eastern	Oost
UG-N, Name for	Northern	Northern
UG-W, Name for	Western	Western
UM-67, Name for	Johnston Atoll	Johnston-atol
UM-71, Name for	Midway Islands	Midway-eilanden
UM-76, Name for	Navassa Island	Navassa-eiland
UM-79, Name for	Wake Island	Wake-eiland
UM-81, Name for	Baker Island	Baker-eiland
UM-84, Name for	Howland Island	Howland-eiland
UM-86, Name for	Jarvis Island	Jarvis-eiland
UM-89, Name for	Kingman Reef	Kingman Rif
UM-95, Name for	Palmyra Atoll	Palmyra-atol
US-AK, Name for	Alaska	Alaska
US-AL, Name for	Alabama	Alabama
US-AR, Name for	Arkansas	Arkansas
US-AS, Name for	American Samoa	Amerikaans-Samoa
US-AZ, Name for	Arizona	Arizona
US-CA, Name for	California	Californië
US-CO, Name for	Colorado	Colorado
US-CT, Name for	Connecticut	Connecticut
US-DC, Name for	District of Columbia	District van Columbia
US-DE, Name for	Delaware	Delaware
US-FL, Name for	Florida	Florida
US-GA, Name for	Georgia	Georgia
US-GU, Name for	Guam	Guam
US-HI, Name for	Hawaii	Hawaii
US-IA, Name for	Iowa	Iowa
US-ID, Name for	Idaho	Idaho
US-IL, Name for	Illinois	Illinois
US-IN, Name for	Indiana	Indiana
US-KS, Name for	Kansas	Kansas
US-KY, Name for	Kentucky	Kentucky
US-LA, Name for	Louisiana	Louisiana
US-MA, Name for	Massachusetts	Massachusetts
US-MD, Name for	Maryland	Maryland
US-ME, Name for	Maine	Maine
US-MI, Name for	Michigan	Michigan
US-MN, Name for	Minnesota	Minnesota
US-MO, Name for	Missouri	Missouri
US-MP, Name for	Northern Mariana Islands	Noordelijke Marianen
US-MS, Name for	Mississippi	Mississippi
US-MT, Name for	Montana	Montana
US-NC, Name for	North Carolina	Noord-Carolina
US-ND, Name for	North Dakota	Noord-Dakota
US-NE, Name for	Nebraska	Nebraska
US-NH, Name for	New Hampshire	New Hampshire
US-NJ, Name for	New Jersey	New Jersey
US-NM, Name for	New Mexico	New Mexico
US-NV, Name for	Nevada	Nevada
US-NY, Name for	New York	New York
US-OH, Name for	Ohio	Ohio
US-OK, Name for	Oklahoma	Oklahoma
US-OR, Name for	Oregon	Oregon
US-PA, Name for	Pennsylvania	Pennsylvania
US-PR, Name for	Puerto Rico	Puerto Rico
US-RI, Name for	Rhode Island	Rhode-eiland
US-SC, Name for	South Carolina	Zuid-Carolina
US-SD, Name for	South Dakota	Zuid-Dakota
US-TN, Name for	Tennessee	Tennessee
US-TX, Name for	Texas	Texas
US-UM, Name for	United States Minor Outlying Islands	Kleine afgelegen eilanden van de Verenigde Staten
US-UT, Name for	Utah	Utah
US-VA, Name for	Virginia	Virginia
US-VI, Name for	Virgin Islands, U.S.	Maagdeneilanden, Amerikaanse
US-VT, Name for	Vermont	Vermont
US-WA, Name for	Washington	Washington
US-WI, Name for	Wisconsin	Wisconsin
US-WV, Name for	West Virginia	West-Virginia
US-WY, Name for	Wyoming	Wyoming
UY-AR, Name for	Artigas	Artigas
UY-CA, Name for	Canelones	Canelones
UY-CL, Name for	Cerro Largo	Cerro Largo
UY-CO, Name for	Colonia	Colonia
UY-DU, Name for	Durazno	Durazno
UY-FD, Name for	Florida	Florida
UY-FS, Name for	Flores	Flores
UY-LA, Name for	Lavalleja	Lavalleja
UY-MA, Name for	Maldonado	Maldonado
UY-MO, Name for	Montevideo	Montevideo
UY-PA, Name for	Paysandú	Paysandú
UY-RN, Name for	Río Negro	Río Negro
UY-RO, Name for	Rocha	Rocha
UY-RV, Name for	Rivera	Rivera
UY-SA, Name for	Salto	Salto
UY-SJ, Name for	San José	San José
UY-SO, Name for	Soriano	Soriano
UY-TA, Name for	Tacuarembó	Tacuarembó
UY-TT, Name for	Treinta y Tres	Treinta y Tres
UZ-AN, Name for	Andijon	Andijon
UZ-BU, Name for	Buxoro	Buchara
UZ-FA, Name for	Farg‘ona	Farg'ona
UZ-JI, Name for	Jizzax	Jizzax
UZ-NG, Name for	Namangan	Namangan
UZ-NW, Name for	Navoiy	Navoiy
UZ-QA, Name for	Qashqadaryo	Qashqadaryo
UZ-QR, Name for	Qoraqalpog‘iston Respublikasi	Ķoraķalpakië, Autonome Republiek
UZ-SA, Name for	Samarqand	Samarkand
UZ-SI, Name for	Sirdaryo	Sirdaryo
UZ-SU, Name for	Surxondaryo	Surxondaryo
UZ-TK, Name for	Toshkent	Toshkent
UZ-TO, Name for	Toshkent	Toshkent
UZ-XO, Name for	Xorazm	Xorazm
VC-01, Name for	Charlotte	Charlotte
VC-02, Name for	Saint Andrew	Saint Andrew
VC-03, Name for	Saint David	Saint David
VC-04, Name for	Saint George	Saint George
VC-05, Name for	Saint Patrick	Saint Patrick
VC-06, Name for	Grenadines	Grenadines
VE-A, Name for	Distrito Capital	Bogotá, Hoofdstedelijk Gewest van
VE-B, Name for	Anzoátegui	Anzoátegui
VE-C, Name for	Apure	Apure
VE-D, Name for	Aragua	Aragua
VE-E, Name for	Barinas	Barinas
VE-F, Name for	Bolívar	Bolívar
VE-G, Name for	Carabobo	Carabobo
VE-H, Name for	Cojedes	Cojedes
VE-I, Name for	Falcón	Falcón
VE-J, Name for	Guárico	Guárico
VE-K, Name for	Lara	Lara
VE-L, Name for	Mérida	Mérida
VE-M, Name for	Miranda	Miranda
VE-N, Name for	Monagas	Monagas
VE-O, Name for	Nueva Esparta	Nueva Esparta
VE-P, Name for	Portuguesa	Portuguesa
VE-R, Name for	Sucre	Sucre
VE-S, Name for	Táchira	Táchira
VE-T, Name for	Trujillo	Trujillo
VE-U, Name for	Yaracuy	Yaracuy
VE-V, Name for	Zulia	Zulia
VE-W, Name for	Dependencias Federales	Federale Afhankelijkheden
VE-X, Name for	La Guaira	La Guajira
VE-Y, Name for	Delta Amacuro	Delta Amacuro
VE-Z, Name for	Amazonas	Amazonas
VN-01, Name for	Lai Châu	Lai Chau
VN-02, Name for	Lào Cai	Lao Cai
VN-03, Name for	Hà Giang	Ha Giang
VN-04, Name for	Cao Bằng	Cao Bang
VN-05, Name for	Sơn La	Son La
VN-06, Name for	Yên Bái	Yen Bai
VN-07, Name for	Tuyên Quang	Tuyen Quang
VN-09, Name for	Lạng Sơn	Lang Son
VN-13, Name for	Quảng Ninh	Quang Ninh
VN-14, Name for	Hòa Bình	Hoa Binh
VN-18, Name for	Ninh Bình	Ninh Binh
VN-20, Name for	Thái Bình	Thai Binh
VN-21, Name for	Thanh Hóa	Thanh Hoa
VN-22, Name for	Nghệ An	Nghe An
VN-23, Name for	Hà Tĩnh	Ha Tinh
VN-24, Name for	Quảng Bình	Quang Binh
VN-25, Name for	Quảng Trị	Quang Tri
VN-26, Name for	Thừa Thiên-Huế	Thua Thien-Hue
VN-27, Name for	Quảng Nam	Quang Nam
VN-28, Name for	Kon Tum	Kon Tum
VN-29, Name for	Quảng Ngãi	Quang Ngai
VN-30, Name for	Gia Lai	Gia Lai
VN-31, Name for	Bình Định	Binh Dinh
VN-32, Name for	Phú Yên	Phu Yen
VN-33, Name for	Đắk Lắk	Dac Lak
VN-34, Name for	Khánh Hòa	Khanh Hoa
VN-35, Name for	Lâm Đồng	Lam Dong
VN-36, Name for	Ninh Thuận	Ninh Thuan
VN-37, Name for	Tây Ninh	Tay Ninh
VN-39, Name for	Đồng Nai	Dong Nai
VN-40, Name for	Bình Thuận	Binh Thuan
VN-41, Name for	Long An	Long An
VN-43, Name for	Bà Rịa - Vũng Tàu	Bà Rịa-Vũng Tàu
VN-44, Name for	An Giang	An Giang
VN-45, Name for	Đồng Tháp	Dong Thap
VN-46, Name for	Tiền Giang	Tien Giang
VN-47, Name for	Kiến Giang	Kien Giang
VN-49, Name for	Vĩnh Long	Vinh Long
VN-50, Name for	Bến Tre	Ben Tre
VN-51, Name for	Trà Vinh	Tra Vinh
VN-52, Name for	Sóc Trăng	Soc Trang
VN-53, Name for	Bắc Kạn	Bac Kan
VN-54, Name for	Bắc Giang	Bac Giang
VN-55, Name for	Bạc Liêu	Bac Lieu
VN-56, Name for	Bắc Ninh	Bac Ninh
VN-57, Name for	Bình Dương	Binh Duong
VN-58, Name for	Bình Phước	Binh Phuoc
VN-59, Name for	Cà Mau	Ca Mau
VN-61, Name for	Hải Dương	Hai Duong
VN-63, Name for	Hà Nam	Ha Nam
VN-66, Name for	Hưng Yên	Hung Yen
VN-67, Name for	Nam Định	Nam Dinh
VN-68, Name for	Phú Thọ	Phu Tho
VN-69, Name for	Thái Nguyên	Thai Nguyen
VN-70, Name for	Vĩnh Phúc	Vinh Phuc
VN-71, Name for	Điện Biên	Dien Bien
VN-72, Name for	Đắk Nông	Dak Nong
VN-73, Name for	Hậu Giang	Hau Giang
VN-CT, Name for	Cần Thơ	Can Tho
VN-DN, Name for	Đà Nẵng	Da Nang (stad)
VN-HN, Name for	Hà Nội	Hanoi
VN-HP, Name for	Hải Phòng	Hai Phong
VN-SG, Name for	Hồ Chí Minh	Ho Chi Minhstad
VU-MAP, Name for	Malampa	Malampa
VU-PAM, Name for	Pénama	Penama
VU-SAM, Name for	Sanma	Sanma
VU-SEE, Name for	Shéfa	Shefa
VU-TAE, Name for	Taféa	Tafea
VU-TOB, Name for	Torba	Torba
WF-AL, Name for	Alo	Alo
WF-SG, Name for	Sigave	Sigave
WF-UV, Name for	Uvea	Uvea
WS-AA, Name for	A'ana	A'ana
WS-AL, Name for	Aiga-i-le-Tai	Aiga-i-le-Tai
WS-AT, Name for	Atua	Atua
WS-FA, Name for	Fa'asaleleaga	Fa'asaleleaga
WS-GE, Name for	Gaga'emauga	Gaga'emauga
WS-GI, Name for	Gagaifomauga	Gagaifomauga
WS-PA, Name for	Palauli	Palauli
WS-SA, Name for	Satupa'itea	Satupa'itea
WS-TU, Name for	Tuamasaga	Tuamasaga
WS-VF, Name for	Va'a-o-Fonoti	Va'a-o-Fonoti
WS-VS, Name for	Vaisigano	Vaisigano
YE-AB, Name for	Abyan	Abyan
YE-AD, Name for	‘Adan	Adana
YE-AM, Name for	‘Amrān	'Amran
YE-BA, Name for	Al Bayḑā’	Al Bayda'
YE-DA, Name for	Aḑ Ḑāli‘	Ad Dali'
YE-DH, Name for	Dhamār	Dhamar
YE-HD, Name for	Ḩaḑramawt	Hadramaut
YE-HJ, Name for	Ḩajjah	Hajjah
YE-HU, Name for	Al Ḩudaydah	Al Hudaydah
YE-IB, Name for	Ibb	Ibb
YE-JA, Name for	Al Jawf	Al Jawf
YE-LA, Name for	Laḩij	Lahij
YE-MA, Name for	Ma’rib	Ma'rib
YE-MR, Name for	Al Mahrah	Al Mahrah
YE-MW, Name for	Al Maḩwīt	Al Mahwit
YE-RA, Name for	Raymah	Raymah
YE-SA, Name for	Amānat al ‘Āşimah [city]	Amanat al-Asimah (stad Sanaa)
YE-SD, Name for	Şāʻdah	Sa'dah
YE-SH, Name for	Shabwah	Shabwah
YE-SN, Name for	Şanʻā’	Sanaa
YE-SU, Name for	Arkhabīl Suquţrá	Socotra
YE-TA, Name for	Tāʻizz	Ta'izz
ZA-EC, Name for	Eastern Cape	Oost-Kaap
ZA-FS, Name for	Free State	Oranje-Vrystaat
ZA-GP, Name for	Gauteng	Gauteng
ZA-KZN, Name for	Kwazulu-Natal	Kwazulu-Natal
ZA-LP, Name for	Limpopo	Limpopo
ZA-MP, Name for	Mpumalanga	Mpumalanga
ZA-NC, Name for	Northern Cape	Noord-Kaap
ZA-NW, Name for	North-West	Noord-West
ZA-WC, Name for	Western Cape	West-Kaap
ZM-01, Name for	Western	Western
ZM-02, Name for	Central	Central
ZM-03, Name for	Eastern	Oost
ZM-04, Name for	Luapula	Luapula
ZM-05, Name for	Northern	Northern
ZM-06, Name for	North-Western	Noord-West
ZM-07, Name for	Southern	Zuid
ZM-08, Name for	Copperbelt	Copperbelt; Kopergordel
ZM-09, Name for	Lusaka	Lusaka
ZM-10, Name for	Muchinga	Machinga
ZW-BU, Name for	Bulawayo	Bulawayo
ZW-HA, Name for	Harare	Harare
ZW-MA, Name for	Manicaland	Manicaland
ZW-MC, Name for	Mashonaland Central	Mashonaland Centraal
ZW-ME, Name for	Mashonaland East	Mashonaland Oost
ZW-MI, Name for	Midlands	Midlands
ZW-MN, Name for	Matabeleland North	Matabeleland Noord
ZW-MS, Name for	Matabeleland South	Matabeleland Zuid
ZW-MV, Name for	Masvingo	Masvingo
ZW-MW, Name for	Mashonaland West	Mashonaland West
